MARGARITA  : SANTIAGO   OPHELIA    ALONZO     CARLTON    JAVIER    
SANTIAGO   : MARGARITA  REGINA     ROSA       ROYCE     
MARVA      : SHELTON    JACQUELYN  MILDRED    JANA       HELENE    
SHELTON    : MARVA      ROMAN      MARCELLA   MINERVA   
SAM        : CANDICE    BILLIE    
CANDICE    : SAM        HOLLIS     CELIA      ELI        HORACE    
COLE       : HERSCHEL   KRIS       JAMIE      FELIPE    
HERSCHEL   : COLE       DENA       SAMANTHA   LYNNETTE   VIOLA     
TERRY      : ADAN       BASIL      GILDA      LETICIA    KARA       GIOVANNI   CORRINE    BIANCA    
TERRY      : MELODY     ANNIE      WILLIAM   
ADAN       : TERRY      ALLIE      DEANN      CELIA      BRANDI     ALISSA     ORVILLE   
WILL       : VICKI      HOMER      LELIA      OLLIE      BURTON    
VICKI      : WILL       MONROE     ALLIE      YOLANDA    ROSANNA   
HELGA      : WADE       ALFRED     RONDA      CLARISSA   LON       
WADE       : HELGA      HOLLY      LYNN       ERMA       SUSANNE    SHERRY     ROYCE     
OFELIA     : BASIL      ROBERTO    LYNDA     
BASIL      : TERRY      OFELIA     WENDI      VICKY      NOE       
GARTH      : MARGARITO  HOWARD    
MARGARITO  : GARTH      SHARI      MEGAN      ZANE       MARCEL    
APRIL      : JOYCE      OLLIE      ERICA      ANGELICA   LEO        RAYMUNDO  
JOYCE      : APRIL      LYNN       FRANCINE   MARY       LYNNE     
RACHAEL    : FEDERICO   HOMER      JUNIOR     EARNEST    ALI        CORNELIUS 
FEDERICO   : RACHAEL    BYRON      JOHN       MARCY      LOLA      
FREEMAN    : JULIA      KATIE      TINA       KELLY      ROSENDO   
JULIA      : FREEMAN    LEMUEL     MOHAMMAD   LACEY      JAVIER    
QUENTIN    : ARTURO     TEDDY      DREW       CLIFF     
ARTURO     : QUENTIN    CHRIS      AMPARO     FERDINAND  HUNTER     PHILIP     CATALINA  
CAROLINE   : CHASITY    SOPHIE     MELISSA   
CHASITY    : CAROLINE   DEE        JOSEPHINE  JANE       WILDA      AUSTIN     DEXTER     BERNIE    
WENDI      : BASIL      RODRIGO    BRYON      ALDO       COY        MARY      
RODRIGO    : WENDI      LES        RONNIE     JERI      
LENARD     : DEON       SOLOMON    ROXIE      PATRICE    JESUS      ANNMARIE  
DEON       : LENARD     JEFF       ELISE      EVANGELINE WILLA     
DOMINIQUE  : WILMER     FRANCISCA  PERCY      BRYAN      IRWIN      EDUARDO    AGUSTIN    LESLEY    
WILMER     : DOMINIQUE  ALPHONSE  
CONRAD     : JUDITH     ELLA       CLEMENT    VIRGIL     ANTONIA   
JUDITH     : CONRAD     STEPHANIE  NATHANIEL 
LUPE       : MARCELINO  SHELLEY    JOSUE      TRINIDAD   DEANA      RAMONA     COLBY      TISHA     
MARCELINO  : LUPE       HESTER     KATHLEEN   CHARLEY    GUILLERMO  MORRIS     DEXTER    
WILFRED    : GONZALO    SUSANNA    CORINNE   
GONZALO    : WILFRED    ARLENE     STEPHAN   
JACKLYN    : DALE       BIANCA     STUART    
DALE       : JACKLYN    LEAH       SILAS      KIMBERLY   ALBERT     MIA       
ILENE      : EARLE      HOMER      AARON      JONAS      RAQUEL     FRANK     
EARLE      : ILENE      THOMAS     JAMIE      TERRENCE   ROSALINDA 
NEVA       : EDGARDO    MEGHAN    
EDGARDO    : NEVA       KEISHA     FANNIE     BRIGITTE  
ELLA       : CONRAD     STELLA     TIM        SHERYL     LEIGH      ILA       
STELLA     : ELLA       JULIUS     GERALD     ELIZA      LAURA      CLAYTON   
TRISTAN    : ADRIANA    TRACY     
ADRIANA    : TRISTAN    MEGHAN     COLLEEN    THEODORE   GARRETT    TERRA      ALI       
TRISHA     : ELIZABETH  CECILIA    JOHNATHAN  ENRIQUE    MARCIA    
ELIZABETH  : TRISHA     COURTNEY   LEVI       RAYMOND   
ALBERTA    : BONNIE     KENTON     ARMANDO   
BONNIE     : ALBERTA    KATY       ALDEN      LIZZIE     AGNES      CHANG      KELSEY     VIRGIL    
BONNIE     : CHARITY    JOSHUA    
REGINA     : SANTIAGO   JODY       LORI       LORIE     
JODY       : REGINA     SANFORD    REFUGIO    RENE       GEOFFREY   DOMINIC    MICAH      ROWENA    
JODY       : ROSENDO   
ISRAEL     : KATY       VERNON     HARVEY     CONNIE    
KATY       : BONNIE     ISRAEL     ROLLAND    DOLLY     
STACEY     : RUPERT     RUSSEL     TINA       REFUGIO    WILBUR     JOCELYN    FELIPE     ROXANNE   
RUPERT     : STACEY     DONNELL    MEGHAN     CLINTON    ISIAH      CHI       
SHELDON    : REGGIE     JULIANNE   AUGUST     DELBERT    INA       
REGGIE     : SHELDON    ALTA       QUINN      GOLDIE     JEFFERSON  JOHNATHAN 
GERARDO    : CHRIS      SONNY      MISTY      LYDIA     
CHRIS      : ARTURO     GERARDO    CHARLEY    LONNIE     STUART     ETTA       CRISTINA   LAKISHA   
CHRIS      : MILLIE     MURRAY     DELMER    
COLEEN     : EDGAR      ELIJAH     BART      
EDGAR      : COLEEN     OCTAVIO    ZANE       JANNIE     KURTIS    
NOELLE     : SHEILA     ALTA       RODGER     WARREN     RICKY     
SHEILA     : NOELLE     JOSH       IGNACIO   
GENARO     : KATIE      HECTOR     AILEEN     DARLENE    QUINCY    
KATIE      : FREEMAN    GENARO     KIMBERLY   BETHANY    BOYD       ALEC      
DONNELL    : RUPERT     HOLLY      DANIEL     JOHNNIE    ROB        MARCIA    
HOLLY      : WADE       DONNELL    EMERY      CORA       CRISTINA   ADELA     
LOUISE     : RAMIRO     MOHAMMED   CASEY      MITCH     
RAMIRO     : LOUISE     ANNETTE    WILLIE     JERROLD    MARCY      KAYLA     
REBEKAH    : JULIO      MARSHA     CAROL      NATALIA    ERWIN     
JULIO      : REBEKAH    SUZANNE    CLAUDIA    TERRANCE   ROSARIO    MAVIS      DARNELL    CINDY     
HOMER      : WILL       RACHAEL    ILENE      ADRIAN     TAMIKA     LESLEY    
ADRIAN     : HOMER      MARTA      DEWITT     HANK       NATHANIEL  AMADO      ALYSSA    
RUDY       : SOPHIE     AURORA    
SOPHIE     : CAROLINE   RUDY       BEAU       CELESTE    ERIC       ZACHARIAH  ESTER     
ADELINE    : ALISA      DARLA      CLAYTON   
ALISA      : ADELINE    LOLITA     SHIRLEY    ELMO       BURL       MIKE      
AUBREY     : CLEO       EDWIN      TAD        CARMEN     HERMINIA   MARIANO   
CLEO       : AUBREY     RANDELL    BERNARDO   RACHEL     WARREN     SANDRA     SALVATORE  ANTONY    
CLEO       : BARBARA    LILLIAN   
PEARL      : SHANNA     PIERRE     MAX       
SHANNA     : PEARL      VANESSA    MARA       ELMA       BRANDON    SABRINA    ELEANOR    MARCY     
RICO       : EZRA       VANESSA    ALVARO     REYES      GUADALUPE  DARRIN     SALVATORE  CELINA    
EZRA       : RICO       DANE       SHAWN      STEFANIE  
ELLIS      : NATASHA    MOHAMED    LATASHA    IGNACIO    MARTHA     BETH      
NATASHA    : ELLIS      ROMEO      AGNES      MARICELA   FRED       DARREN    
JUSTINE    : ALDEN      ALVIN     
ALDEN      : BONNIE     JUSTINE    JOHNNIE    ERICKA     FRANKLIN   MEL        CLEVELAND  GROVER    
DONA       : GREGORIO   DARLENE    FLORINE    IRIS       PAULA     
GREGORIO   : DONA       SETH       CONCETTA   EILEEN     NELSON     BRIAN     
MYRA       : ODESSA     ADAM       CARLA     
ODESSA     : MYRA       HILARIO    CHANDRA    CESAR      WOODROW    FOSTER    
ANASTASIA  : BRYON      KERRI      FREDRIC   
BRYON      : WENDI      ANASTASIA  MARCEL     VANCE     
JASON      : SAVANNAH   NANNIE     DONN       FORREST    ERIK       BOBBIE    
SAVANNAH   : JASON      KARI       RANDOLPH   LARA      
EDWINA     : AIDA       JAMEL      CHANCE     RICKY     
AIDA       : EDWINA     WILLARD    RAY        NICOLAS    MARCUS    
MARTIN     : MERVIN     DANIEL     JERMAINE   MALCOLM    LYNDA     
MERVIN     : MARTIN     DELORIS    MATHEW    
IRVIN      : LYNN       KIRK       WILBUR     TOMMY      MAC       
LYNN       : WADE       JOYCE      IRVIN      HEATH      CASEY      JORGE      MITCHEL    SONDRA    
LYNN       : LUKE       JESS      
CHADWICK   : SANDY      ALVA       LILIANA    BIANCA    
SANDY      : CHADWICK   LELIA      EDWIN      KENNETH    TREVOR     BRANT     
GALE       : ASHLEY     NATHAN     REINALDO   JOHANNA    AMADO      MAYNARD   
ASHLEY     : GALE       TONIA      GREG       GRACIE     MEL        KENDALL    NAPOLEON   MARCELLA  
ASHLEY     : BRANDI     CALEB      ELOY       BOBBIE     ODELL     
LEMUEL     : JULIA      GABRIELA   JACKIE     JANICE     CARRIE     LILY      
GABRIELA   : LEMUEL     RAUL       HUBERT     ERIC       SALLIE    
JOSEPH     : BROOKS     JOAN       CHAUNCEY   CHUCK     
BROOKS     : JOSEPH     JACKIE     JOSH       ETHAN     
KENNY      : BRET       BARRY      EVE        CHRISTI    MATHEW    
BRET       : KENNY      RONNIE     DOMINICK  
ALVA       : CHADWICK   KRISTI     MINNIE     MAXWELL    CAITLIN   
KRISTI     : ALVA       BLAKE      CHANDRA    DAWN       RAMONA     LESA      
MONA       : RUSSEL     LAVERNE    ROLLAND    AMADO      CLARISSA  
RUSSEL     : STACEY     MONA       FLETCHER  
SUSANNA    : WILFRED    DANE       KARLA      NEWTON     HARVEY    
DANE       : EZRA       SUSANNA    BARTON     ROMEO      EVAN      
TABATHA    : CHRYSTAL   MERRILL    JOAQUIN    CARA       AMPARO    
CHRYSTAL   : TABATHA    GWEN       GAIL       LUCIO     
STANLEY    : WAYNE      ANTONIA    TAMIKA     MATILDA    BRAIN     
WAYNE      : STANLEY    ADAM       STEVEN     KERMIT    
SHAWN      : EZRA       LEOLA      VALERIE    GILDA      KENNETH    JOANNE     FRITZ      DONALD    
SHAWN      : TANIA      RUTH       DEVIN      ELI        CHUCK      KIRSTEN   
LEOLA      : SHAWN      MARA       MELODY     ALYCE     
DWAYNE     : DARWIN     MERLIN     RENE       CALVIN     ROSIE      MAGDALENA 
DARWIN     : DWAYNE     SUZANNE    LETA       KRISTA     ERIK       IVA        JARRED     MATILDA   
LELIA      : WILL       SANDY      EDMOND     KRIS       JULIAN     IVAN       PEARLIE    INES      
LIZA       : SASHA      MIGUEL     KELLIE     TOMAS      CHERI      JEANNE    
SASHA      : LIZA       KEN        ALMA       NELL      
SUZANNE    : JULIO      DARWIN     LOUIE      BEVERLEY   GIL        NEWTON    
EMERY      : HOLLY      CHRISTIAN  GENA       BENNY      HALLIE    
HANNAH     : SERGIO     VIRGINIA  
SERGIO     : HANNAH     JACQUELYN  MYRNA     
OLEN       : MONROE     TOD        CAREY      ZACHERY    JORGE      VINCE     
MONROE     : VICKI      OLEN       DINA       AARON      NANETTE    BRADLEY    BETTE      BERNARD   
MERRILL    : TABATHA    CASEY      CRISTINA  
ANNETTE    : RAMIRO     TOBY       CASEY      GEORGIA   
TOBY       : ANNETTE    SHELBY     EVANGELINA
KORY       : FRANCES    MABLE      DARRIN     MARCI     
FRANCES    : KORY       PORFIRIO   CASEY      DEANN      DEREK      TERI       NOEL       LUKE      
FRANCES    : HARVEY     ELLIOTT    ALEXANDER 
BOBBI      : DIONNE     DARLA      LEILA      INA        OPAL      
DIONNE     : BOBBI      STEVE     
MYRTLE     : LOUISA     MARION     HUNTER    
LOUISA     : MYRTLE     JORDAN     MARGRET    JO         TRAVIS    
ANDRES     : BROCK      JAMIE      KARLA      ART        JOLENE    
BROCK      : ANDRES     MARIANNE   FELIX     
FOREST     : VANESSA    LINDA      RACHEL     JAY        BELINDA   
VANESSA    : SHANNA     RICO       FOREST     JOANNE     ROXIE      HUNTER    
KARL       : DANIEL     ISIDRO     CALVIN     LEILA      DOMINIC    ANGEL      ALBERTO   
DANIEL     : DONNELL    MARTIN     KARL       GRANT      KARA       PASQUALE  
MEGHAN     : NEVA       ADRIANA    RUPERT     TODD       JAMEL      ELTON      TWILA     
ADAM       : MYRA       WAYNE      DAREN      TERRANCE   DARIO     
IRVING     : MOLLY      TERRIE     CLAUDE     MARITZA    LOUIS     
MOLLY      : IRVING     WALKER    
MELISA     : BRITTNEY   EBONY      THOMAS     CARSON    
BRITTNEY   : MELISA     NANETTE    TONI       PABLO     
HECTOR     : GENARO     DION       MARION     BERNARD    CLINT      THAD      
DION       : HECTOR     JIMMIE     JILL       DOMINGO   
BENITO     : VICKY      IMOGENE    ALTON     
VICKY      : BASIL      BENITO     HUGO      
JULIET     : DARRYL     LELAND     ALEJANDRO  SHARI      JOHNNY    
DARRYL     : JULIET     TANYA      DEIDRE    
MELANIE    : THADDEUS   SCOTT      EVE        BLANCHE   
THADDEUS   : MELANIE    ROBERT     GAVIN      JUDY       MITCH      CYRUS     
JEREMIAH   : ERVIN      HAL        DELBERT   
ERVIN      : JEREMIAH   THEODORE   DAVIS      SHARON     MADELYN   
GRANT      : DANIEL     SONNY     
CORA       : HOLLY      RAFAEL     MATTHEW    ALLISON    KAY       
RAFAEL     : CORA       DEBBIE     ADELA     
ANNA       : ALINE      TANIA     
ALINE      : ANNA       KRIS       ZACHERY    PAIGE     
FRANCISCA  : DOMINIQUE  ARCHIE     MOISES     MARJORIE   PRINCE    
ARCHIE     : FRANCISCA  JENNY      MATTHEW    NORBERTO  
LOLITA     : ALISA      LOTTIE     KERRY      LILIAN    
LOTTIE     : LOLITA     MARION     HALEY      LAURIE     BERYL      MANUEL    
NATALIE    : NIGEL      ELBERT     BUDDY     
NIGEL      : NATALIE    LETITIA    OCTAVIO    STERLING   RUSTY      LUTHER     CATALINA  
AURELIO    : RUFUS      JARED      DAMIAN    
RUFUS      : AURELIO    HEATHER    MARGO      ALISSA     ERIK       JUANA     
SETH       : GREGORIO   BIANCA     MAUDE     
GEORGE     : DEAN       MAXWELL    JEANETTE  
DEAN       : GEORGE     COLETTE    TRACY      EDDY       TRENT     
HILARIO    : ODESSA     TROY       MARTINA   
ROGER      : ALFRED     PARKER     DENA       KATHRYN    YOLANDA    BRENT     
ALFRED     : HELGA      ROGER      JERRI     
HORACIO    : BRIDGET    DELORES    KATRINA   
BRIDGET    : HORACIO    TAMMY      JULIUS     ADOLFO    
CRUZ       : KATELYN    DAMION     BETHANY    WELDON    
KATELYN    : CRUZ       RUTH       MAVIS     
MARTA      : ADRIAN     JULIETTE   CLAIR      REINALDO   LOLA       ARNOLD    
JACKIE     : LEMUEL     BROOKS     LILIANA    EUGENIO    JAMIE      JOLENE     MEREDITH   SUE       
LILIANA    : CHADWICK   JACKIE     DEWAYNE    BETTE      DWIGHT    
LORI       : REGINA     DINA       RAUL       JANA       LENNY     
DINA       : MONROE     LORI       SIMON      SCOT      
BUFORD     : CLAUDIA    MANDY      KIM        DEBORA     DONALD    
CLAUDIA    : JULIO      BUFORD     COLETTE    ZACHERY   
FREDERIC   : LEONARD    ROBIN      NADIA      ALTON     
LEONARD    : FREDERIC   JEFFEREY  
KENDRICK   : ROBYN      DANA       CHAD       MARLENE    MARTY     
ROBYN      : KENDRICK   STUART     KARLA      BENNIE     IMELDA    
DELORIS    : MERVIN     GWENDOLYN  ERMA       KIETH     
GWENDOLYN  : DELORIS    FRANCIS   
JESSICA    : NORA       BYRON      LUKE      
NORA       : JESSICA    HOUSTON   
BLAKE      : KRISTI     JANETTE    SHANA      FRANCESCA  CAROL      PHYLLIS   
JANETTE    : BLAKE      FRANCIS    ANDRE      JOSH       GEORGETTE  ALVIN      CLEVELAND  ROGELIO   
VIVIAN     : TERRI      REBECCA   
TERRI      : VIVIAN     JOHN       CLIFFORD  
NITA       : CORNELIA   CHANDRA    BILLY      KELLY      ZELMA      SHELIA     ESSIE     
CORNELIA   : NITA       NOE        FLOYD     
ROBIN      : FREDERIC   HARRIETT   MILES      DALTON     CATHLEEN   JEAN       ELENA      DARNELL   
ROBIN      : GRETCHEN   TIMMY     
HARRIETT   : ROBIN      TORY       HAL        DEREK      ALMA      
SUSIE      : EDMOND     SOPHIA     LORENA     ART        OLIVIA    
EDMOND     : LELIA      SUSIE      JIM       
BORIS      : MILES      GILBERT    FAYE       PRINCE    
MILES      : ROBIN      BORIS      EDDY       ZACHARY   
LOREN      : WILMA      JANICE     CHARITY    BENNETT   
WILMA      : LOREN      MONIQUE    LENORA     DENISE    
CHANDRA    : ODESSA     KRISTI     NITA       JOHNNY     MEREDITH   LOUELLA    VANCE     
ELAINE     : JOHNNIE    PORFIRIO   ALFREDO    CORINA     TRINIDAD  
JOHNNIE    : DONNELL    ALDEN      ELAINE     LEAH       DUANE      CYRIL      GLENDA     JOHNIE    
JOHNNIE    : CRISTINA   ERIC       KATHARINE  SEAN      
ELVA       : DAMON      MARIA      JESSE      DELORES   
DAMON      : ELVA       ADA        SONNY      CARL       ALLAN     
ERIN       : AILEEN     JEROME     MILLARD    FLOYD      CRISTINA   LOGAN      CARTER    
AILEEN     : GENARO     ERIN       KRISTOPHER
MARLA      : LANE       BEAU      
LANE       : MARLA      ROXANNE    GROVER    
HENRY      : THERESE    JORGE      DORIS      LOYD       GERTRUDE   EVERETT   
THERESE    : HENRY      FAY        TRACI      JILL       LYDIA      MILAGROS  
NOEMI      : VELMA      TAMARA     LORENE     CHRISTI    JO         CLARISSA  
VELMA      : NOEMI      PAULINE    CHRISTIAN  CHAD       LENORA     PATRICE    OMAR      
LELAND     : JULIET     SHELLEY    LEONOR     KURT       DOROTHY    AVIS      
SHELLEY    : LUPE       LELAND     JODI       EMILE      SHANE      NICKOLAS  
ALEXIS     : MATT       TAYLOR     CATHLEEN   CHERRY     WILBUR     WILBERT    THELMA     VONDA     
ALEXIS     : KITTY     
MATT       : ALEXIS     COLEMAN    JOHANNA    CARLOS    
ERMA       : WADE       DELORIS    JACKSON    SAMANTHA   KATHRINE   JEANNINE   KIMBERLEY 
JEANINE    : ALDO       DEBORA    
ALDO       : WENDI      JEANINE    EULA       ELOISE    
SIMON      : DINA       LEONARDO   JILLIAN    LUCY       LAKEISHA   MURRAY    
KERRY      : LOLITA     DORTHY     JEANETTE   IRA        KYLE       BERRY      MAUDE      LORETTA   
DAWN       : KRISTI     LEAH       RANDELL    ROSALIND  
LEAH       : DALE       JOHNNIE    DAWN       HEATH      GLEN       SHANE      FAUSTINO  
JOSEFINA   : VICTOR     VALERIA    CLEMENT    TERRELL    ADDIE     
VICTOR     : JOSEFINA   KEISHA     TEDDY      LORNA      DODO       BRIANA    
AARON      : ILENE      MONROE     WHITNEY    LESLIE     PETE      
WHITNEY    : AARON      CLIFFORD   DIANN      PHILIP    
ESTEBAN    : FREDDIE    JAMAL      LUCILE     RAMON     
FREDDIE    : ESTEBAN    SILVIA     LILA       CASSIE    
WILFORD    : ANTWAN     AMALIA     GORDON    
ANTWAN     : WILFORD    MERLIN     ASHLEE     IDA       
AUDRA      : RUBIN      VALARIE    NATALIA   
RUBIN      : AUDRA      CLIFTON    SHARLENE   JONATHAN   FREDDY     MACK       BEVERLY   
GILBERTO   : NOE        MORGAN    
NOE        : BASIL      CORNELIA   GILBERTO   BLANCA     HARRISON  
LUZ        : KIP        CHANCE    
KIP        : LUZ        CLAY       LINCOLN    MICAH      BRICE      ENID      
STEFAN     : BARRY      GERALDINE  SAMANTHA   PATRICE   
BARRY      : KENNY      STEFAN     MARI       HARLEY    
ORA        : ELVIRA     JOANN      CARLENE    ZACHARIAH  LANDON    
ELVIRA     : ORA        OCTAVIO    HIRAM      MIA        MARI       THERESA   
VALERIE    : SHAWN      HEATH      JEANNETTE  JOSIE     
HEATH      : LYNN       LEAH       VALERIE    MICHEL    
MARGARET   : FRANCIS    LIZZIE     JULIETTE   CRISTINA   FREDDY    
FRANCIS    : GWENDOLYN  JANETTE    MARGARET   CONSUELO   CARLY      JOY        HELENA     LETHA     
FRANCIS    : CELINA     CHUCK     
CHARLIE    : MINNIE     AUDREY    
MINNIE     : ALVA       CHARLIE    DEBORA     RYAN       REYNA      LACY       NICHOLE   
ISABEL     : JOSUE      RANDELL    OPHELIA   
JOSUE      : LUPE       ISABEL     MABEL      CORINNE   
ALEJANDRO  : JULIET     LAWANDA    LATISHA    JEANNIE    ALANA      JACLYN     CELESTE   
LAWANDA    : ALEJANDRO  SALVADOR   EDWIN      DIANNE     JULIANA    RORY      
BILL       : YOUNG      JENNIE     BILLY      SEAN       MAJOR     
YOUNG      : BILL       DEREK      ROYAL      JOLENE     PASQUALE   CLARE      LORRAINE   INEZ      
JEROME     : ERIN       CARLY      LUELLA    
TIM        : ELLA       MABLE      ARLENE     CORINNE    DERICK    
TOD        : OLEN       DEWAYNE    THOMAS     STEFANIE   CHARLES   
DEWAYNE    : LILIANA    TOD        SANG       BOBBY      ROBBY      CATALINA   NORMAN     ODELL     
JULIANNE   : SHELDON    SHERRIE   
LAWRENCE   : PAMELA     WESTON     MOSES      FELECIA   
PAMELA     : LAWRENCE   NADINE     EDMUND     SAMMY      MAURO      DOROTHEA  
COLETTE    : DEAN       CLAUDIA    WILLARD    MICHELLE   WANDA      JIMMY     
WILLARD    : AIDA       COLETTE    LUISA      RUTH       IVA       
DAREN      : ADAM       EUGENE     CARLY      JEAN       GOLDIE     CARLO     
EUGENE     : DAREN      RONNY     
MOHAMMED   : LOUISE     MARYELLEN  RUSSELL    AUGUSTUS   ISABELLA   CLARK      LORIE      SADIE     
PORFIRIO   : FRANCES    ELAINE     CHRISTOPER
DARLA      : ADELINE    BOBBI     
LUCIEN     : LEANNE     AUGUST     DANA       JEAN       SYLVESTER  GENEVIEVE 
LEANNE     : LUCIEN     AUGUSTINE  QUINN      LUCIA      OLA       
JOANN      : ORA        MILLARD   
MILLARD    : ERIN       JOANN      COURTNEY   JAY        TESSA      JONAH     
ALVARO     : RICO       JAMAAL     KIMBERLY   ISABELLE   DEANN      LYMAN      TRINA      MARIO     
JAMAAL     : ALVARO     DESMOND    MARINA    
DUSTY      : NANNIE     EMMANUEL   KATHY      JERALD     ROSELLA    CHAUNCEY  
NANNIE     : JASON      DUSTY      KENNETH    EMERSON    ALLYSON    ELSIE      TARA       CLARE     
NANNIE     : MARIAN    
JIM        : EDMOND     ROSEANN    KATRINA    ROCCO     
ROSEANN    : JIM        BARTON     TRINA     
CONSUELO   : FRANCIS    VERNA      ROLLAND    MURRAY    
VERNA      : CONSUELO   LIZZIE     GERALDINE  JUAN       WALLACE    JOSEFA    
HUGH       : EUGENIO    JUNIOR     MIGUEL     BRENT     
EUGENIO    : JACKIE     HUGH       KENDALL    OLIN       CELESTE    PHOEBE     ALYCE     
NOREEN     : ALTA       JULES      TERI       ELWOOD    
ALTA       : REGGIE     NOELLE     NOREEN     CHAD      
MARIA      : ELVA       LANNY      TODD       JANELL     JONI       JOLENE     SUSANA     STEWART   
LANNY      : MARIA      KEN        TORY       CLIFFORD   ROSALIND  
HESTER     : MARCELINO  REYES      DUNCAN     SERENA    
REYES      : RICO       HESTER     MARYELLEN  ROMAN      ANDREA     BEN       
KIRBY      : ANDRE      ANGELO     ANNIE      LEANNA     JOSE       BRIAN     
ANDRE      : JANETTE    KIRBY      ALEJANDRA  CLARISSA  
HOLLIS     : CANDICE    SONIA      CAROL      SALLY      PHILIP     VERA      
JENNIE     : BILL       NESTOR     LUCIO      REGINALD  
STEVIE     : ROSALIE    FAY        RONDA      LOUIS     
ROSALIE    : STEVIE     JOSEPHINE  JOSEF      PAT        LYNNETTE  
SANFORD    : JODY       MOLLIE     ADA        GUS        STAN      
CASEY      : LOUISE     LYNN       MERRILL    ANNETTE    FRANCES    ALYSON     ARRON      THURMAN   
CASEY      : MAMIE      SONDRA    
ALYSON     : CASEY      JEWELL     DEE        ARACELI    JO         JOSEFA    
PETER      : JEWELL     NUMBERS    JAIME      BERNARD    LAURA     
JEWELL     : ALYSON     PETER      ISABELLE   ELMA       TANYA      NATHANIEL 
MURIEL     : LAUREN     DAISY      KELLY      JOCELYN   
LAUREN     : MURIEL     LEON       JOHN       RILEY      RAYMOND   
ESTELLA    : JONAS      KRISTINA   EMILIA    
JONAS      : ILENE      ESTELLA    DEWEY      SYLVIA    
MICHELLE   : COLETTE    BARNEY     WINFRED   
SALVADOR   : LAWANDA    GEORGINA   CONSTANCE 
GEORGINA   : SALVADOR   LUCINDA    DINO       NINA      
SYDNEY     : KRIS       ROSANNE    WILLIE     LOIS      
KRIS       : COLE       LELIA      ALINE      SYDNEY     DEANDRE    ALANA      TAMERA     DORA      
KRIS       : COLBY      SHERI      ARNULFO    CECELIA   
ISIDRO     : KARL       ADRIENNE  
MERLIN     : DWAYNE     ANTWAN     AL         TISHA     
AL         : MERLIN     CLIFTON    WILLIE     CHANG      ANDY       SOFIA      FRIEDA     ARNOLD    
GLENN      : ARTHUR     EFRAIN     AHMED     
ARTHUR     : GLENN      BOB        NEIL      
KATHERINE  : HUMBERTO   CHESTER    JAME       TYSON      ROWENA     MARVIN    
HUMBERTO   : KATHERINE  BILLIE     ANGELA    
BERT       : MOLLIE     JODIE     
MOLLIE     : SANFORD    BERT       FORREST   
WILSON     : LEANN      VALENTIN   PATRICK   
LEANN      : WILSON     RACHELLE   HELENA     BRANT      WILTON    
DEANNA     : EUGENIA    FERNANDO   RICHIE     BRICE      PHILIP     MARIANO   
EUGENIA    : DEANNA     MARLON     VILMA     
GILDA      : TERRY      SHAWN      TAYLOR     ALLIE      JULIUS     TREY       ABE       
TAYLOR     : ALEXIS     GILDA      NONA       ROYAL      ROSEMARY   CLAUDIO    ALEJANDRA 
IMOGENE    : BENITO     MARSHA     MERLE      TAMRA     
MARSHA     : REBEKAH    IMOGENE    GARLAND   
RICK       : RANDY      JANELL     WESTON     BRENT     
RANDY      : RICK       JEROLD     RAY       
JON        : LIZZIE     GIL        CHESTER    CARLOS     DELMER    
LIZZIE     : BONNIE     MARGARET   VERNA      JON        ERIC       FELECIA   
MABLE      : KORY       TIM        BLANCA     VIOLET     THURMAN    LOUIS     
BLANCA     : NOE        MABLE      BERTA     
FAY        : THERESE    STEVIE     ALLIE      CAROLYN    ALBERTO   
ALLIE      : ADAN       VICKI      GILDA      FAY        GARRY     
KEVIN      : MARISOL    YVETTE     LAVERNE   
MARISOL    : KEVIN      BARTON     BILLIE     DALTON    
ELLEN      : PARKER     INES      
PARKER     : ROGER      ELLEN      GARRY      DIXIE      DANTE     
JULIETTE   : MARTA      MARGARET   GWEN       JULIE      STEPHEN    BROOKE     SAMUEL     LUKE      
GWEN       : CHRYSTAL   JULIETTE   LOUIE      COLLIN     RALPH      JUSTIN     VERA      
JIMMIE     : DION       GRAHAM     SAUL       NESTOR     HILARY     DINO       CURTIS    
GRAHAM     : JIMMIE     MATTIE     KATHLEEN   NANCY      MARISSA   
CAREY      : OLEN       JANET      ERNESTINE  ROSETTA    BRENDA     PAM        CLARK      SHAWNA    
KENDRA     : ANGELO     MICAH      DAVE      
ANGELO     : KIRBY      KENDRA     JANICE     SHANE      JERROD    
BARBRA     : VERONICA   PATRICA    WILEY      CLAYTON   
VERONICA   : BARBRA     ROXIE      LILLIE     MERCEDES   HUGO       CARLENE   
SHANA      : BLAKE      ROCHELLE   ROMAN      CORRINE    RICARDO   
ROCHELLE   : SHANA      SEBASTIAN  FERNANDO  
ROY        : TRACY      TAMMY      JANINE     DAPHNE    
TRACY      : TRISTAN    DEAN       ROY        DENA       JARROD     ERICKA     SARAH      EVANGELINE
TRACY      : RAYMUNDO  
LOWELL     : MERLE      DEANDRE    LUCINDA    DOMINGO   
MERLE      : IMOGENE    LOWELL     SUMMER     NONA       VIOLET     SPENCER    ANNIE      MILLIE    
MERLE      : NORBERTO   FELICIA    BERRY      ESTER     
LISA       : JAKE       SANG       VALERIA    SHANNON   
JAKE       : LISA       BLAINE    
EDDY       : DEAN       MILES      JOSH       ANITA      REVA      
JOSH       : SHEILA     BROOKS     JANETTE    EDDY       GLEN       DIANN      CHERIE    
JODI       : SHELLEY    HUNTER    
STEVE      : DIONNE     CLIFTON    SHEREE     CAITLIN    LIDIA     
CLIFTON    : RUBIN      AL         STEVE      ANTON      GREG       SHARI      OCTAVIO   
JANICE     : LEMUEL     LOREN      ANGELO     SHIRLEY    TAMMY      MAURA      IVANA      MARVIN    
JANICE     : DENVER    
MICHEL     : HEATH      WILLIS     ADELE      KELLIE    
CESAR      : ODESSA     BILLY      DOUGLAS    MOSES      GARY       EARLINE   
BILLY      : NITA       BILL       CESAR      MAE        DIEGO      LARRY      ROLANDO   
AUGUST     : SHELDON    LUCIEN     DEMETRIUS  JANINE     EDWARD    
DEMETRIUS  : AUGUST     JEFFERY    ROSEMARY   CLIFF      GRETA     
WILLIS     : MICHEL     JIMMY      ABEL       LENNY     
EDWIN      : AUBREY     SANDY      LAWANDA    LEONARDO   GLENNA     BILLIE     DARREL     CANDY     
EDWIN      : CARMINE   
LEONARDO   : SIMON      EDWIN      NOLAN      WARREN     DANIELLE  
SELENA     : SANG       LELA      
SANG       : DEWAYNE    LISA       SELENA     RYAN       SARAH      TED       
ESTELLE    : SHIRLEY    CHERYL     EMILIO    
SHIRLEY    : ALISA      JANICE     ESTELLE    MONICA     TYLER      ANTONIA    TWILA      MARC      
MARYELLEN  : MOHAMMED   REYES      ESMERALDA  ELVIA      TED        LORAINE    ALISHA    
ESMERALDA  : MARYELLEN  COURTNEY   LAMONT     SHARRON   
BARTON     : DANE       ROSEANN    MARISOL    JOEY      
COLEMAN    : MATT       NADIA      LAVERNE    JUDY       LUCIA     
NADIA      : FREDERIC   COLEMAN    MARGUERITE CATHRYN   
JOAQUIN    : TABATHA    FRANCESCA  BRYANT     KENNITH    NOEL       MARCEL    
FRANCESCA  : BLAKE      JOAQUIN    ROXIE      DINO       TIMMY      DUDLEY     AMELIA    
TRACEY     : TRUDY      WESLEY     EMILE      SHELBY     SHANNON    LARRY      LYNETTE    FRANKIE   
TRUDY      : TRACEY     SALLY      LIDIA     
AMALIA     : WILFORD    MARILYN    CORNELL    GERMAN     HANS       RANDAL    
MARILYN    : AMALIA     WALTER     DEIRDRE    RODRICK    TAMRA     
ROBERT     : THADDEUS   FRANCINE   KRYSTAL    NICOLE     NELDA      BERNARD    MARSHALL   INA       
FRANCINE   : JOYCE      ROBERT     RODGER     JAMEL      DENISE    
BETTIE     : DENA       CORINA     NICOLE     NED        RUSTY     
DENA       : HERSCHEL   ROGER      TRACY      BETTIE     RENE       EVAN      
DOREEN     : LETICIA    ALBA       NATALIA    FOSTER    
LETICIA    : TERRY      DOREEN     HENRIETTA  DARRELL    LETHA     
TAMARA     : NOEMI      LORENA     STEWART    RORY       ZACHARY   
ANGELIQUE  : KRYSTAL    RUDOLPH    VINCENT    LEA        SYLVIA    
KRYSTAL    : ROBERT     ANGELIQUE 
KELLEY     : LOUIE      JESSIE     WYATT     
LOUIE      : SUZANNE    GWEN       KELLEY     JULIAN     DARCY     
SELMA      : ORVAL     
ORVAL      : SELMA      TIMMY      LYDIA     
SHERMAN    : TAD        PHILLIP    JED        CHARITY    TOM        ERNA      
TAD        : AUBREY     SHERMAN    MEL        ALICIA     AMELIA     SCOTTY    
YVETTE     : KEVIN      GREGG      ALICIA     CLAIRE    
DUANE      : JOHNNIE    DORTHY    
DORTHY     : KERRY      DUANE      CHANCE     NOAH       NORBERTO   TIA       
JARROD     : TRACY      DEE        SUNG       LORETTA   
DEE        : CHASITY    ALYSON     JARROD     ALBA       DONALD     ANDY       JEANNETTE  CANDY     
DEE        : TIFFANY   
RANDELL    : CLEO       DAWN       ISABEL     HIRAM      WALLACE   
BRIDGETTE  : ALFREDO    ROSETTA    WILBERT   
ALFREDO    : ELAINE     BRIDGETTE  HEATHER    SUSANNE    GLENDA     ALLEN      DODO       BRETT     
KATHRYN    : ROGER      KRISTY     KENNITH   
KRISTY     : KATHRYN    RYAN       KELLIE     LATOYA    
SAMMIE     : BERNADINE  EBONY      ADOLPH     STEFANIE   LILA       RACHELLE   ETHAN      JOSIAH    
BERNADINE  : SAMMIE     FREDERICK  DALLAS     SHERI      JOSE      
MONIQUE    : WILMA      CLAY       STEFANIE  
CLAY       : KIP        MONIQUE    AMPARO    
RICHARD    : RUBEN      SHERYL     DIANE      NADINE     TERRIE    
RUBEN      : RICHARD    DENNY     
SILAS      : DALE       CORRINE   
KARA       : TERRY      DANIEL     TERENCE   
TINA       : FREEMAN    STACEY     GRACE     
CHELSEA    : COREY      WENDY      MORGAN     PHILIP    
COREY      : CHELSEA    LYLE       GENEVA     JANIS      HARVEY    
LETITIA    : NIGEL      SOPHIA     OLGA      
SOPHIA     : SUSIE      LETITIA    GRACIE     FLETCHER   WILEY     
JANET      : CAREY      DONNA      PAULINE    EMILY     
DONNA      : JANET      JACQUELYN  CRAIG      JANIE     
REFUGIO    : JODY       STACEY     JOSEPHINE  DEANN      JERROLD    PHYLLIS   
JOSEPHINE  : CHASITY    ROSALIE    REFUGIO    TAMEKA     JOSEF     
ROMAN      : SHELTON    REYES      SHANA      YOLANDA    BESSIE     CLARISSA  
TONIA      : ASHLEY     MAE        DEANA     
KENNETH    : SANDY      SHAWN      NANNIE     AURORA     CYRUS     
DOUGLAS    : CESAR      WALKER     SPENCER    THAD      
GLENNA     : EDWIN      LEA        LARA       THANH      ADDIE     
MELVA      : BERNARDO   ABDUL      GRACIELA   STEPHEN    KAREN     
BERNARDO   : CLEO       MELVA      JARED      CLAUDE     GRETA     
ANITA      : EDDY       LATONYA    LAKEISHA  
LATONYA    : ANITA      GALEN      SHARON    
ELBA       : KEN        KRISTINE   NIKKI      ANTONY    
KEN        : SASHA      LANNY      ELBA       TEDDY      SHERYL     BRADFORD  
KIMBERLY   : DALE       KATIE      ALVARO     HELEN      ROSELLA    BEULAH    
LINDA      : FOREST     BETTY      JASMINE    NICOLAS    EVERETT   
MAE        : BILLY      TONIA      CORRINE    FELIPE     CALLIE    
SONIA      : HOLLIS     DIANNA     NIKKI      DEWITT     SHARI      HALEY      SAMMY     
DIANNA     : SONIA      BRAIN     
RENE       : JODY       DWAYNE     DENA       PANSY      GEORGETTE  ISMAEL     EMMETT     VONDA     
PANSY      : RENE       BETTY      RACHELLE   CAMILLE    SHARON     LOYD       STEWART    JILL      
ANTON      : CLIFTON    CLINT      ABIGAIL   
DEANDRE    : KRIS       LOWELL     JAME       LINA       AMADO      ALEX      
CARA       : TABATHA    LULU       LESLIE     JACLYN     HAROLD     KURT      
LULU       : CARA       SHELLY     CURTIS     LILLIAN   
ZACHERY    : OLEN       ALINE      CLAUDIA    ALEXANDRA  AUSTIN    
MICHAEL    : JARED      MOISES     FERDINAND  SALLY      JONATHON   ANN        AMANDA     DANNY     
JARED      : AURELIO    BERNARDO   MICHAEL    HOUSTON    FLORENCE   SHEREE     NANCY      ALYSSA    
RUDOLPH    : ANGELIQUE  JEANIE     MARJORIE   LATASHA    LUISA      ALFONSO    NICK      
JEANIE     : RUDOLPH    MONTY      ISMAEL     EARNESTINE FAITH      MARGERY   
BRUCE      : WILLIAMS   FREIDA     MARI      
WILLIAMS   : BRUCE      FERDINAND  HEIDI      RAQUEL     LOUIS     
HOUSTON    : NORA       JARED      SUSAN      GERTRUDE   CRYSTAL   
ELVIS      : CARMEN     ROSANNE    COY        TIMOTHY    CONSTANCE  CAROLE     THANH     
CARMEN     : AUBREY     ELVIS      TOMMY      FELICIA    JEFFREY   
GREG       : ASHLEY     CLIFTON    CAROL     
PAULINE    : VELMA      JANET      CHRISTOPER REVA      
RAUL       : GABRIELA   LORI       FAYE       DONALD     SPENCER    THAD      
ADA        : DAMON      SANFORD    GAIL      
MARQUIS    : RUSSELL    WILLIE     ABRAHAM    ANTONY    
RUSSELL    : MOHAMMED   MARQUIS    MILTON     WILLA     
MIRIAM     : JAMAL      MARIANA   
JAMAL      : ESTEBAN    MIRIAM     LUCIANO    JANIS      CHRISTA    JUANITA    SONJA     
FLORENCE   : JARED      HARRY      SCOTT      DONALD     MELODY     ISSAC     
HARRY      : FLORENCE   LAMONT     ROSLYN     CHRISTA    IVANA     
DARLENE    : GENARO     DONA       ADRIENNE   JOSEF      LORRAINE   DOYLE     
ADRIENNE   : ISIDRO     DARLENE    RICH       NED       
JESSIE     : KELLEY     CARISSA    BIANCA     NANCY      DORA       FELIX      CHRISTINA 
JACKSON    : ERMA       LEON       CLARENCE   BART       BURT       LORRAINE  
LEON       : LAUREN     JACKSON    KRISTINA   LORA       ARMAND     KENTON     MASON     
LINDSEY    : CAROLYN    BRADY      MORGAN     FANNIE     ABBY       LETHA     
CAROLYN    : FAY        LINDSEY    RONDA     
TODD       : MEGHAN     MARIA      OLLIE      IRWIN      RONALD    
OLLIE      : WILL       APRIL      TODD       HEATHER    HARRIET    ROBBIE     DOLORES    ROOSEVELT 
MOHAMED    : ELLIS      DELLA      MELINDA    TAMI      
DELLA      : MOHAMED    MAUREEN    REYNA     
CARMELA    : VINCENT    DALTON    
VINCENT    : ANGELIQUE  CARMELA    TREVOR     KENDALL    DARYL     
MONTY      : JEANIE     JAMAR      LETA       LYNETTE    BRADLY    
JAMAR      : MONTY      PETE      
BETSY      : MAY       
MAY        : BETSY      AVERY      EVERETTE  
JERMAINE   : MARTIN     GEOFFREY   BRAD      
GEOFFREY   : JODY       JERMAINE   JULIUS     VICKIE     LESTER     NELSON     BRADFORD  
SAUNDRA    : DANNIE     MAUREEN   
DANNIE     : SAUNDRA    CHARLEY    CELESTE    LAKISHA    QUINTON   
KRISTINE   : ELBA       KRISTINA   ODIS      
KRISTINA   : ESTELLA    LEON       KRISTINE   JOSEF      KELSEY    
RACHEL     : CLEO       FOREST     JOEY       BRAIN     
CALVIN     : DWAYNE     KARL       ALEXANDRIA BUD       
HATTIE     : EMANUEL    ABIGAIL    JOESPH    
EMANUEL    : HATTIE     GORDON     TERRIE     WENDELL    MITCHEL    LENNY     
CARLA      : MYRA       SUMMER     HAL        CYRUS     
SUMMER     : MERLE      CARLA      LAVERNE    SONYA      MARIETTA   SYLVESTER  TERRENCE  
WYATT      : KELLEY     LENORE     ERICK      BART      
BETTY      : LINDA      PANSY      COLLEEN    GALEN      ERROL     
ROSANNE    : SYDNEY     ELVIS      SOLOMON   
HUBERT     : GABRIELA   PAT       
BEATRICE   : DUNCAN     ADOLPH     BRIDGETT   MARCOS    
DUNCAN     : HESTER     BEATRICE   KATHERYN  
JOANNE     : SHAWN      VANESSA    MARJORIE   KIETH      RHONDA    
ARLENE     : GONZALO    TIM        SCOT       ROBT      
SCOT       : DINA       ARLENE     ERICK      FELIPE     ANTOINETTE ARON      
CARLY      : FRANCIS    JEROME     DAREN      NUMBERS    CARLOS     JEFFREY    ENRIQUE   
RUBY       : EMERSON    JOHN       EARLINE   
EMERSON    : NANNIE     RUBY       VINCE     
PERCY      : DOMINIQUE  CHANG      LESSIE     DESIREE    DIANN      DARIO     
ISABELLE   : ALVARO     JEWELL     JEFF       JEANETTE  
ERICKA     : ALDEN      TRACY      BERNICE    SOLOMON    ROLAND    
BERNICE    : ERICKA     KELLY      CLAUDINE  
FRANKLIN   : ALDEN      ELBERT     JULES      ELLIOTT   
LAVERNE    : MONA       KEVIN      COLEMAN    SUMMER     LEONA      BURT       INES      
MAYRA      : NONA       FAYE      
NONA       : TAYLOR     MERLE      MAYRA      BONITA    
WARD       : WINSTON    JOAN       KENTON     HERMINIA   CORINNE    MARGIE    
WINSTON    : WARD       ROLANDO   
LORA       : LEON       THOMAS     JEWEL      MICHEAL    FERNANDO   ELTON      KELLIE     DUDLEY    
TANISHA    : BERTA      TESSA      AMBER      KELLIE    
BERTA      : BLANCA     TANISHA    CARY       HOLLIE     MORGAN     RITA       KAYLA     
RAPHAEL    : REED      
REED       : RAPHAEL    CHARLEY    ETTA       CAMERON    EMILE      TANIA      MEREDITH   OPAL      
MAXWELL    : ALVA       GEORGE     ODIS       BRANDI     VICENTE    KENNITH    PATRICA    HARLAN    
ODIS       : KRISTINE   MAXWELL    HARRIET    PAT        CLAUDINE   TAMMI     
LATISHA    : ALEJANDRO  BEVERLEY   ESSIE      ABE       
BEVERLEY   : SUZANNE    LATISHA    TARA       PIERRE     MALINDA    DOMINGO   
HEATHER    : RUFUS      ALFREDO    OLLIE      DANA       GUADALUPE  BLAIR      BEULAH    
MELINDA    : MOHAMED    SHELIA    
RAE        : NIKKI      MAURICE    VONDA     
NIKKI      : ELBA       SONIA      RAE        LEA       
ERNESTINE  : CAREY      JASPER     JEFFERSON  DOMINGO   
TREVOR     : SANDY      VINCENT    DANIAL     DIEGO      HILARY     TIA        MARYANNE  
DANIAL     : TREVOR     DAMION     ERNEST     CRAIG      MAXINE    
CLINTON    : RUPERT     JANELLE    JEANNE    
ABDUL      : MELVA      AUGUSTUS   MARLIN     ROSLYN     SHELBY     SHANNON    BLANCHE   
AUGUSTUS   : MOHAMMED   ABDUL      BILLIE     LUANN      SARAH     
HELEN      : KIMBERLY   ARRON      FREDRICK   JOEY       MORRIS     HERSHEL   
SCOTT      : MELANIE    FLORENCE   ALEX       LELA      
KIRK       : IRVIN      FREIDA     MILTON     SERENA     ANGELINE   JUDSON    
FREIDA     : BRUCE      KIRK       ROBBIE     LYNNE     
MOISES     : FRANCISCA  MICHAEL    WENDY      ERICH     
ROMEO      : NATASHA    DANE       ANNE       LORRIE     SHELIA     LOIS       CLARE      DONNIE    
MANDY      : BUFORD     MAURICIO  
MAURICIO   : MANDY      RONNY      CHERIE     TONI      
JULIAN     : LELIA      LOUIE      JOHANNA   
VALENTIN   : WILSON     BOB        FREDRICK   LEONA      WOODROW    COLIN      BRENTON   
JORGE      : LYNN       OLEN       HENRY      NATALIA    URSULA     BROOKE    
FERN       : KASEY      MISTY      BUDDY      SALLIE    
KASEY      : FERN       JONATHAN   MALINDA   
BILLIE     : SAM        HUMBERTO   MARISOL    EDWIN      AUGUSTUS   EBONY      KATRINA    ROSALIND  
BILLIE     : LORENZO   
EBONY      : MELISA     SAMMIE     BILLIE     CHARITY    GUY        MARICELA  
KIM        : BUFORD     GILBERT    DEREK      JERALD     LEIGH      RICKIE     JAN        JERROD    
GILBERT    : BORIS      KIM        KIETH      LESTER    
NATHAN     : GALE       GIL        STACI     
GIL        : SUZANNE    JON        NATHAN     TRENT      EARL      
SILVIA     : FREDDIE    KARI       MARIETTA   EVELYN    
KARI       : SAVANNAH   SILVIA     YVONNE    
GIOVANNI   : TERRY      REBECCA    DREW       KIRSTEN   
SUSAN      : HOUSTON    LARA       CARROLL    ELWOOD    
RANDOLPH   : SAVANNAH   LESLIE     MADELEINE  NELDA      STERLING  
LESLIE     : AARON      CARA       RANDOLPH   TASHA      OSVALDO    MARICELA   XAVIER    
WENDY      : CHELSEA    MOISES     JESUS      ANGELINE  
MARA       : SHANNA     LEOLA      LAURENCE   MARY       KATHRINE   WILBURN   
THOMAS     : EARLE      MELISA     TOD        LORA       GUSTAVO    ANDERSON  
CARISSA    : JESSIE     TYRONE     REUBEN    
AMPARO     : ARTURO     TABATHA    CLAY      
DEWITT     : ADRIAN     SONIA      BETTE      ANDERSON   DOLLIE    
DORIS      : HENRY      CORNELL   
CORNELL    : AMALIA     DORIS      ALEC      
SAUL       : JIMMIE     JILLIAN    MAURA      MISTY     
JILLIAN    : SIMON      SAUL       LINA       AGUSTIN   
MILTON     : RUSSELL    KIRK       ROSEMARIE  BRENDA     FERNANDO   GAY       
VALERIA    : JOSEFINA   LISA       KAREEM    
MARJORIE   : FRANCISCA  RUDOLPH    JOANNE    
LINCOLN    : KIP        ANGELA     GEORGETTE  DODO       LESLEY    
ANGELA     : HUMBERTO   LINCOLN    GAYLE      RUTHIE     MICKEY     JOSE      
FLOYD      : CORNELIA   ERIN       ROSE       ALICE      CECIL     
LES        : RODRIGO    FABIAN     ADOLPH     DORIAN     RICARDO   
FABIAN     : LES        BRANDIE    LAMAR      HERSHEL   
GARLAND    : MARSHA     SUSANNE    JIMMY      ALFREDA    RAMON      SYBIL      MAJOR     
SUSANNE    : WADE       ALFREDO    GARLAND    TORY       JERROD    
POLLY      : GRACIE     ALBA       FANNY      GRADY      BERYL      JOEL       FLOSSIE    CINDY     
GRACIE     : ASHLEY     SOPHIA     POLLY      LILIA      AUGUSTA   
GREGORY    : CHARMAINE  ROD        ROSA      
CHARMAINE  : GREGORY    CYRIL      ARMAND     CLYDE     
FAYE       : BORIS      RAUL       MAYRA      IVY        ELOY       LEIGH      MELVIN    
MITZI      : LUCY       VIOLA      LEONEL    
LUCY       : SIMON      MITZI      BRIDGETT   ELVIA      INGRID     MASON      LLOYD     
FRITZ      : SHAWN      JOHNATHON  RICH       NICKOLAS   MARTINA   
ISIAH      : RUPERT     CORINA     SONNY      GAYLE      SERENA     MILO      
CORINA     : ELAINE     BETTIE     ISIAH      CAMERON   
ALBERT     : DALE       FREDRICK   DAMIEN     ADOLFO    
OPHELIA    : MARGARITA  ISABEL     JEFF       BRYAN      IRA        CECILIA    JARRETT   
JEFF       : DEON       ISABELLE   OPHELIA    IMELDA     ESSIE     
MADELINE   : ROSETTA    JOHNIE     EVERETTE  
ROSETTA    : CAREY      BRIDGETTE  MADELINE   MAUREEN    OLGA       LATOYA     CARMELO   
NORMAND    : YONG      
YONG       : NORMAND    ZANE       JONATHON   ANTOINETTE
LAURENCE   : MARA       NEWTON    
DARREL     : EDWIN      HILDA      MURRAY     PEARLIE    JANELLE    FRANKIE   
ADOLPH     : SAMMIE     BEATRICE   LES        GARRETT    MILO       JOSEFA    
JEANETTE   : GEORGE     KERRY      ISABELLE   PATRICIA   TESSA      OMAR      
JOHNATHON  : FRITZ      CYRIL      PAIGE      CARSON    
CYRIL      : JOHNNIE    CHARMAINE  JOHNATHON  CANDACE   
CARMELLA   : DALTON    
DALTON     : ROBIN      MARISOL    CARMELA    CARMELLA   CARLO      DARIO     
SONNY      : GERARDO    GRANT      DAMON      ISIAH      GUADALUPE  GERMAN     JEFFREY    MARCELO   
SHARI      : MARGARITO  JULIET     CLIFTON    SONIA     
PRISCILLA  : MARIBEL    KERRI      MARCUS     MARIE      CARTER     REBA      
MARIBEL    : PRISCILLA  JONATHAN   KURT      
TORY       : HARRIETT   LANNY      SUSANNE    GERALDINE  TRACI      IAN        IRENE     
GERALDINE  : STEFAN     VERNA      TORY       EFFIE      ROSARIO    ROCCO     
TRACI      : THERESE    TORY       TRINIDAD   MARIAN    
TRINIDAD   : LUPE       ELAINE     TRACI     
TOMMIE     : CATHLEEN   ANGELINA   SERENA     BROOKE    
CATHLEEN   : ROBIN      ALEXIS     TOMMIE     LOIS       ELLIOT    
DEBORA     : BUFORD     JEANINE    MINNIE     TOMMY      JAMES      JAIME      DARNELL   
COURTNEY   : ELIZABETH  MILLARD    ESMERALDA  CLARISSA   DON       
GRACE      : TINA       JANE       DREW       SOFIA      ROB        MONTE      BRITNEY   
JANE       : CHASITY    GRACE      ROLAND    
SONYA      : SUMMER     MEL        AVERY     
MEL        : ALDEN      ASHLEY     TAD        SONYA     
MARIANNE   : BROCK      DELIA      ELIJAH     HILDA      ANNIE     
ALEXANDRIA : CALVIN     GENE       NELLIE     ESTELA     LINDSAY   
AUGUSTINE  : LEANNE     RYAN       DONN       PEGGY     
RYAN       : MINNIE     SANG       KRISTY     AUGUSTINE  CLYDE      LAKISHA    TYLER      FRANK     
MABEL      : JOSUE      SOCORRO    MITCHELL  
SOCORRO    : MABEL      LEVI      
JOHNNY     : JULIET     CHANDRA   
LATASHA    : ELLIS      RUDOLPH    WARREN     ERNESTO    REUBEN     RODOLFO   
SHAUNA     : BERTHA     PENNY      WELDON     HUNG      
BERTHA     : SHAUNA     TYSON      BELINDA    CHARLENE   MITCHEL   
WESLEY     : TRACEY     MATTIE     ALBERTO   
MATTIE     : GRAHAM     WESLEY     ANA        TAMI       BEVERLY   
RICKEY     : GENE       WANDA      CHERRY     TAMEKA    
GENE       : ALEXANDRIA RICKEY     LILA       MEREDITH  
DANA       : KENDRICK   LUCIEN     HEATHER    WANDA      ELSIE      SANDRA     GENEVIEVE  EDDIE     
WANDA      : COLETTE    RICKEY     DANA       VERNON     ESTELA     CECIL     
BEAU       : SOPHIE     MARLA      ROXANNE   
KATHLEEN   : MARCELINO  GRAHAM     CLARICE    DERICK     MAGGIE    
ERICA      : APRIL      BERTIE     ELINOR     CURTIS     EMMA      
COLLEEN    : ADRIANA    BETTY      LENORE     HENRIETTA  BARBARA   
LENORE     : WYATT      COLLEEN   
ALBA       : DOREEN     DEE        POLLY      THEODORE   SHANNON    URSULA    
THEODORE   : ADRIANA    ERVIN      ALBA       LUCILE    
MAUREEN    : DELLA      SAUNDRA    ROSETTA    TRINA     
LEVI       : ELIZABETH  SOCORRO    CHRISTIE   JARRETT    ZACHARIAH 
STEFANIE   : EZRA       TOD        SAMMIE     MONIQUE   
HARRIET    : OLLIE      ODIS       RICARDO    JERI      
KAITLIN    : CHRISTIAN  ALFREDA    FRANKIE    JEFFRY    
CHRISTIAN  : EMERY      VELMA      KAITLIN    DERRICK    KIETH      AGUSTIN    HANS       BENITA    
CHRISTIAN  : MILLICENT  THANH     
REBECCA    : VIVIAN     GIOVANNI   CORRINE    KERRI      SHEENA     LOYD       FRANKIE   
CORRINE    : TERRY      SHANA      SILAS      MAE        REBECCA    KEISHA     FREDDY     ILA       
TAMMY      : BRIDGET    ROY        JANICE    
QUINN      : REGGIE     LEANNE     NELDA      HARLAN    
TYRONE     : CARISSA    GLENDA     CECILIA    MELVIN    
GLENDA     : JOHNNIE    ALFREDO    TYRONE    
EMILIA     : ESTELLA    JENNIFER   HILARY     BENNY      RAYMOND   
MOHAMMAD   : JULIA      GERARD     BARNEY     DICK      
GERARD     : MOHAMMAD   JOAN       MAURICE    XAVIER    
JEANNIE    : ALEJANDRO  LANA       BRANT     
JEREMY     : ALLYSON    SUSANA     BENITA    
ALLYSON    : NANNIE     JEREMY     EFREN     
ADELE      : MICHEL     ALONZO     JACOB      TREY      
ALONZO     : MARGARITA  ADELE      PATRICE    TRUMAN     CARLTON   
LYLE       : COREY      ROSEMARIE  CHRISTINE 
ROSEMARIE  : MILTON     LYLE       FREDA      JONAH      MATILDA    DERICK    
CHESTER    : KATHERINE  JON        NETTIE     CHERYL     IVORY     
NETTIE     : CHESTER    VILMA      SHAWNA    
CHARLEY    : MARCELINO  CHRIS      DANNIE     REED       SEBASTIAN  TABITHA    ROSELLA   
BRYAN      : DOMINIQUE  OPHELIA    ANNE      
ANNE       : ROMEO      BRYAN      DARIN      SYLVESTER  CORY       NORMAN    
FLORINE    : DONA       WINFRED    JEAN       BERRY     
ARMAND     : LEON       CHARMAINE  SHERRIE   
GENEVA     : COREY      CHRISTY    ANTONIO    JANNA     
CHRISTY    : GENEVA     SAMANTHA   DANNY      JEANNINE  
ELSIE      : NANNIE     DANA       DIEGO      NICOLE    
DAISY      : MURIEL     ROSIE      JASMINE    EARLENE    PEGGY      ELLIOT    
ROSIE      : DWAYNE     DAISY      MEAGAN    
BIANCA     : TERRY      JACKLYN    CHADWICK   SETH       JESSIE     EVE        CLINT      CHRISTINE 
HANK       : ADRIAN     KEISHA     DINO      
KEISHA     : EDGARDO    VICTOR     CORRINE    HANK       PAT       
CHERRY     : ALEXIS     RICKEY     DEANA      FLETCHER   GLORIA     STAN      
DEANA      : LUPE       TONIA      CHERRY    
LONNIE     : CHRIS      GRADY     
STUART     : JACKLYN    CHRIS      ROBYN      LAUREL     ELOY       DAPHNE     DELMER     AVIS      
JOHNIE     : JOHNNIE    MADELINE   ALANA      DARRIN    
ALANA      : ALEJANDRO  KRIS       JOHNIE     RALPH      DODO      
LILA       : FREDDIE    SAMMIE     GENE       JACLYN     MARION     BRIGITTE  
BARNEY     : MICHELLE   MOHAMMAD   NESTOR     ELISE     
NESTOR     : JENNIE     JIMMIE     BARNEY     CLAIR      ROXIE      AURELIA    GENEVIEVE 
JULIUS     : STELLA     BRIDGET    GILDA      GEOFFREY  
JAME       : KATHERINE  DEANDRE   
ETTA       : CHRIS      REED       ELBERT     SHELBY    
YOLANDA    : VICKI      ROGER      ROMAN      CRAIG      DARNELL    ENRIQUE   
JACQUES    : ELMO       ISABELLA   BRIANNA   
ELMO       : ALISA      JACQUES    ELEANOR   
VIRGIE     : TAMEKA     TRACIE    
TAMEKA     : JOSEPHINE  RICKEY     VIRGIE     DESMOND    CARL       LEE       
JEWEL      : LORA       ROBBIE     WINNIE     ELBERT     OTTO       LUCAS     
ROBBIE     : OLLIE      FREIDA     JEWEL      NUMBERS    BRANDEN    DODO       BRUNO      CONNIE    
ROBBIE     : BERNIE    
CRISTINA   : CHRIS      HOLLY      MERRILL    JOHNNIE    ERIN       MARGARET   COLBY      ANGEL     
CRISTINA   : SCOTTY    
KENDALL    : ASHLEY     EUGENIO    VINCENT    ROSALYN   
DEANN      : ADAN       FRANCES    ALVARO     REFUGIO    ZANE       DILLON     WALDO      AVERY     
CHAD       : KENDRICK   VELMA      ALTA       GAVIN     
FERDINAND  : ARTURO     MICHAEL    WILLIAMS   ZANE       DEVIN     
LORENA     : SUSIE      TAMARA     BRADFORD  
PHILLIP    : SHERMAN    GENA       RONALD     THURMAN    ESTHER     ARON      
GENA       : EMERY      PHILLIP    LEE        ALAN      
BYRON      : FEDERICO   JESSICA    JEROLD    
LEA        : ANGELIQUE  GLENNA     NIKKI      MARQUITA  
SHELLY     : LULU       SAMANTHA   RHEA       TAMRA      DOLLIE    
SAMANTHA   : HERSCHEL   ERMA       STEFAN     CHRISTY    SHELLY     GARRETT    ROD        MILLIE    
ELMA       : SHANNA     JEWELL     NAPOLEON   IRWIN      GUSTAVO   
GREGG      : YVETTE     WILLIE     CLYDE      LEE       
ROSANNA    : VICKI      SOLOMON    ANTONIO    ANGEL     
SOLOMON    : LENARD     ROSANNE    ERICKA     ROSANNA    TANYA      CARLO      ADDIE     
JEROLD     : RANDY      BYRON      AUTUMN     JUNIOR     ALISON     MICAH      JULIANA   
ROCKY      : MAURA      VALARIE    JANA      
MAURA      : JANICE     SAUL       ROCKY      TY         OLIVIA     JANNIE     DARIO      STACY     
WINFRED    : MICHELLE   FLORINE    NOLAN      CONCETTA   KARIN     
NOLAN      : LEONARDO   WINFRED    AUGUSTA   
TANYA      : DARRYL     JEWELL     SOLOMON    KAREN     
LINA       : DEANDRE    JILLIAN    RONDA      JUANITA   
RONDA      : HELGA      STEVIE     CAROLYN    LINA       BENJAMIN   MAMIE      MAVIS      AMANDA    
ELISA      : DEBRA      DANTE      NED        LUCINDA   
DEBRA      : ELISA      ELVIA     
TERENCE    : KARA       EMIL       GAYLE      MILDRED    ALBERTO    REGINALD  
DONALD     : SHAWN      BUFORD     DEE        RAUL       FLORENCE   JOEL      
TEDDY      : QUENTIN    VICTOR     KEN       
AGNES      : BONNIE     NATASHA    PERRY      GERTRUDE  
JAMIE      : COLE       EARLE      ANDRES     JACKIE     MARY       CHARLOTTE  CLYDE      JEANNETTE 
JAMIE      : INA        MARCEL    
PATRICIA   : JEANETTE   ALLISON    BURL      
JESSE      : ELVA       EILEEN     XAVIER    
LUANN      : AUGUSTUS   HAL        ERIC      
HAL        : JEREMIAH   HARRIETT   CARLA      LUANN     
TY         : MAURA      BRENDAN    MARGO      BESSIE    
BRENDAN    : TY         ANGIE      LOGAN      ROYAL     
JOSEF      : ROSALIE    JOSEPHINE  DARLENE    KRISTINA   DREW       LUCILE    
RANDI      : LORRIE     JUANA      CASSIE    
LORRIE     : ROMEO      RANDI      JOAN       MILLIE     LANDON    
COY        : WENDI      ELVIS      MERCEDES   AMADO     
NANETTE    : MONROE     BRITTNEY   SHERRI    
MELODY     : TERRY      LEOLA      FLORENCE   SCOTTY    
LAMONT     : ESMERALDA  HARRY      ELOY       CAROLE     PHIL       JOHNATHAN  AVA        JODIE     
LEILA      : BOBBI      KARL       KAYE       JEANNETTE  KAYLA     
DESMOND    : JAMAAL     TAMEKA     DAVIS     
DAVIS      : ERVIN      DESMOND    MARCO     
CLAIR      : MARTA      NESTOR     GABRIEL    PENNY      JUNE      
GABRIEL    : CLAIR      MALLORY    STEVEN    
OSCAR      : NUMBERS    PATTI     
NUMBERS    : PETER      CARLY      ROBBIE     OSCAR      JAMES      LAKEISHA   KELSEY     VICKIE    
MARLIN     : ABDUL      LIZ        OWEN       CASSANDRA  STEPHAN    THELMA     TRENTON    QUEEN     
LIZ        : MARLIN     GAVIN      ROSE       JOHNATHAN  JEANNINE  
NAPOLEON   : ASHLEY     ELMA       TONY       DEWEY     
BOOKER     : CURT       MORRIS    
CURT       : BOOKER     IVAN       THERESA    ADDIE     
SEBASTIAN  : ROCHELLE   CHARLEY    BRANDIE    IAN        NORBERT    MILFORD   
BRANDIE    : FABIAN     SEBASTIAN  ELTON      MORTON     REX       
VIOLET     : MABLE      MERLE      CELIA      KELLY      LUELLA    
CELIA      : CANDICE    ADAN       VIOLET     RUTHIE     HAROLD    
DAMION     : CRUZ       DANIAL     WINNIE     RHODA     
WINNIE     : JEWEL      DAMION     DEIRDRE    TRENTON   
GAIL       : CHRYSTAL   ADA        CHARLENE   TISHA      CRYSTAL   
CAMERON    : REED       CORINA     EFFIE      WILLIAM   
EFFIE      : GERALDINE  CAMERON    SHERYL     JAMEL      ANA        BRANDY    
AUTUMN     : JEROLD    
DARIN      : ANNE       ROXIE      LUCILE     TAMRA     
ROXIE      : LENARD     VANESSA    VERONICA   FRANCESCA  NESTOR     DARIN      LILLY     
BRANDEN    : ROBBIE     WILLIE     KELVIN     EMILIO    
WILLIE     : RAMIRO     SYDNEY     AL         MARQUIS    GREGG      BRANDEN    MATTHEW    JOHN      
WILLIE     : ERNESTO    JARRED     MATILDA    LADONNA   
TROY       : HILARIO    COCO       CONNIE    
COCO       : TROY       TREY       RANDALL   
LAUREL     : STUART     BELINDA    MARISA     DOLLY     
GUILLERMO  : MARCELINO  GARRY      OCTAVIO    ORLANDO    PEDRO     
GARRY      : ALLIE      PARKER     GUILLERMO  JIMMY      EMMETT    
JENNY      : ARCHIE     MATTHEW    LAMAR      TRENT      BUD       
MARY       : JOYCE      WENDI      MARA       JAMIE      JACQUELYN  MEGAN      AMY        EDDIE     
MARY       : REGINALD   GLADYS    
JACQUELYN  : MARVA      SERGIO     DONNA      MARY       DIXIE      LIONEL     TAMRA     
JULIE      : JULIETTE   DREW       JAMES      CECIL     
DREW       : QUENTIN    GIOVANNI   GRACE      JOSEF      JULIE      PEDRO      JEANNE     MAUDE     
GORDON     : WILFORD    EMANUEL    FIDEL      CHRISTA    AMANDA    
FIDEL      : GORDON     MIGUEL     VANCE     
BRYCE      : HERIBERTO  ALICE      JOSHUA     BERNIE    
HERIBERTO  : BRYCE      MALINDA    STACY      ED        
GAVIN      : THADDEUS   CHAD       LIZ        DENNIS     REYNALDO  
DENNIS     : GAVIN      CLIFFORD   DONOVAN   
JACLYN     : ALEJANDRO  CARA       LILA       IRMA       SEAN       CHASE     
IRMA       : JACLYN     SHARON     BRITNEY    ELOISE    
MARCELLA   : SHELTON    ASHLEY     VITO       ARACELI    ZACHARIAH 
PAT        : ROSALIE    HUBERT     ODIS       KEISHA     ELNORA     ELOY       FERNANDO   REID      
JANELL     : MARIA      RICK       BRIDGETT   MANUEL    
WILBUR     : STACEY     IRVIN      ALEXIS     WILEY     
MARION     : MYRTLE     HECTOR     LOTTIE     LILA       SIDNEY     MORTON     JUAN       BURT      
MARION     : RHONDA     LOUELLA    CHERI     
PATTI      : OSCAR      RACHELLE   CHANCE    
RACHELLE   : LEANN      SAMMIE     PANSY      PATTI      DEIDRE    
JENNIFER   : EMILIA     CAROL      DALLAS    
CAROL      : REBEKAH    BLAKE      HOLLIS     GREG       JENNIFER   JAN       
BRANDI     : ADAN       ASHLEY     MAXWELL    PATRICE    BEATRIZ   
TOMMY      : IRVIN      CARMEN     DEBORA     ETHAN     
ERNEST     : DANIAL     SHERYL     EMILY      ANTONY    
SHERYL     : ELLA       RICHARD    KEN        EFFIE      ERNEST     JAYNE     
SHARLENE   : RUBIN      JONATHAN   ELISEO     BOBBIE     KERMIT     WILBURN   
JONATHAN   : RUBIN      KASEY      MARIBEL    SHARLENE   CAMILLE    FELICIA   
ANGIE      : BRENDAN    RAMONA     WILFREDO  
CLARA      : CHARLES    MADELEINE  ANGELICA  
CHARLES    : TOD        CLARA      KAREN      RITA      
OLGA       : LETITIA    ROSETTA   
LENORA     : WILMA      VELMA      AISHA      MEAGAN     ARNOLD     MARCIE    
DELIA      : MARIANNE   LILIA     
LILIA      : GRACIE     DELIA      TERESA     KATE      
RHODA      : DAMION     FLETCHER   ELMER      STACI     
KELLI      : CHRISTOPER ISABELLA   FELICIA    BECKY     
CHRISTOPER : PORFIRIO   PAULINE    KELLI      ANDREA     LEIGH      DAN       
JAMES      : DEBORA     NUMBERS    JULIE      DONN       HARLEY    
DONN       : JASON      AUGUSTINE  JAMES     
ANGELINA   : TOMMIE     ANTONE     LYMAN     
ANTONE     : ANGELINA   LESSIE     PABLO      EVA       
CLEMENT    : CONRAD     JOSEFINA   CYNTHIA    TIFFANY   
BOB        : ARTHUR     VALENTIN   LOGAN      PAIGE      LEROY     
LOGAN      : ERIN       BRENDAN    BOB        SALLY     
KARLA      : SUSANNA    ANDRES     ROBYN      NICKOLAS  
JUDY       : THADDEUS   COLEMAN    TANNER     MARLON    
TANNER     : JUDY       IRWIN     
ELIJAH     : COLEEN     MARIANNE   FREDDY    
FREDDY     : RUBIN      MARGARET   CORRINE    ELIJAH     NATHANIEL  CORNELIUS 
GINA       : IGNACIO    RAYMOND   
IGNACIO    : SHEILA     ELLIS      GINA       BRADY      KRISTOPHER
NELLIE     : ALEXANDRIA LETA      
LETA       : DARWIN     MONTY      NELLIE     STACIE     ROSA       MORTON    
ANGELIA    : IVAN       EARNESTINE
IVAN       : LELIA      CURT       ANGELIA   
CORINE     : ROSE       VICKIE     DOYLE     
ROSE       : FLOYD      LIZ        CORINE     CAITLIN    AVERY     
ART        : ANDRES     SUSIE      EMILE      DELORES    ROBBY     
EMILE      : SHELLEY    TRACEY     REED       ART        GABRIELLE  SUE       
ARRON      : CASEY      HELEN      BENNETT   
DIANE      : RICHARD    BRIDGETT   CASSANDRA 
BRIDGETT   : BEATRICE   LUCY       JANELL     DIANE      JAIME      FELECIA    REYNALDO  
NADINE     : PAMELA     RICHARD   
JORDAN     : LOUISA     KRISTIE    LEONA      EDUARDO    SIDNEY     AMY        PATRICA   
KRISTIE    : JORDAN     TERESA     LILLIE     MARINA     FELICIA    NELL      
BRADLEY    : MONROE     GEORGETTE  AMBER      KEITH     
GEORGETTE  : JANETTE    RENE       LINCOLN    BRADLEY   
CRAIG      : DONNA      DANIAL     YOLANDA    OLIVIA     BERTIE     CLARENCE   EDDIE     
RONNY      : EUGENE     MAURICIO   BENJAMIN  
CAMILLE    : PANSY      JONATHAN   ELIZA      DARRELL    DYLAN     
ELBERT     : NATALIE    FRANKLIN   ETTA       JEWEL     
JIMMY      : COLETTE    WILLIS     GARLAND    GARRY      LESSIE    
ISABELLA   : MOHAMMED   JACQUES    KELLI      MARLON     MONTE     
GARRETT    : ADRIANA    ADOLPH     SAMANTHA   TAMIKA    
BENNIE     : ROBYN      EMIL       HOLLIE     MAVIS     
MONICA     : SHIRLEY    FREDRIC   
BRADY      : LINDSEY    IGNACIO    ALEC      
JASMINE    : LINDA      DAISY      RHEA       ROLANDO    CONCEPCION
RHEA       : SHELLY     JASMINE   
OLIN       : EUGENIO    KELLY      CATALINA  
DIRK       : BRENDA     ALISSA     SHEREE     ETHEL     
BRENDA     : CAREY      MILTON     DIRK       CARROLL   
JASPER     : ERNESTINE  EDNA       KRISTIN    MURRAY     LETHA     
GLEN       : LEAH       JOSH       ALPHONSO   GINO       JERRI     
WALKER     : MOLLY      DOUGLAS    ASHLEE    
CONCETTA   : GREGORIO   WINFRED    KIETH      CLAUDIO    TERRELL    NEAL      
ULYSSES    : AURORA     STEPHANIE  MYRON      CARROLL    ADELA     
AURORA     : RUDY       KENNETH    ULYSSES    VONDA     
LORNA      : VICTOR    
ROD        : GREGORY    SAMANTHA   IVANA     
MISTY      : GERARDO    FERN       SAUL       JAY        NICHOLAS   LACY      
JAY        : FOREST     MILLARD    MISTY      STACIE     MYRON      FELICIA    MADGE     
DOLORES    : OLLIE      EMMANUEL   GRACIELA   ROSLYN     WILBERT    CECILE     ROXANNE   
EMMANUEL   : DUSTY      DOLORES   
EMIL       : TERENCE    BENNIE     EDITH     
EDITH      : EMIL       RITA       JEFFERSON 
DENNY      : RUBEN      ALFREDA    WENDELL    ANDERSON   ABE       
ALFREDA    : GARLAND    KAITLIN    DENNY      BOBBIE    
CALEB      : ASHLEY     MITCHELL   MARCOS    
MITCHELL   : MABEL      CALEB      CASSANDRA 
MATTHEW    : CORA       ARCHIE     WILLIE     JENNY      GRACIELA   LULA       MARISA    
GRACIELA   : MELVA      DOLORES    MATTHEW    ELSA      
LAVERN     : JUNIOR     MELISSA    MERCEDES   DOUG      
JUNIOR     : RACHAEL    HUGH       JEROLD     LAVERN     DAVE      
PENNY      : SHAUNA     CLAIR      PERRY      ANTONY    
PERRY      : AGNES      PENNY      FERNANDO   DELMER    
CARY       : BERTA      DERRICK   
DERRICK    : CHRISTIAN  CARY       EULA       JEFFERY   
CHANG      : BONNIE     AL         PERCY     
OCTAVIO    : EDGAR      NIGEL      ELVIRA     CLIFTON    GUILLERMO  ANDREA     IRA       
ANDREA     : REYES      CHRISTOPER OCTAVIO    FANNY      TAMMI     
MARIETTA   : SUMMER     SILVIA     SANDRA     ESSIE     
ALLEN      : ALFREDO   
MARGRET    : LOUISA     DUSTIN     ERROL      MARIO      FRED      
DUSTIN     : MARGRET    FANNY      JARRETT   
FORREST    : JASON      MOLLIE     ANDY       GERALD     EVERETTE  
ANDY       : AL         DEE        FORREST    MAURICE    WILLIAM    KITTY     
SALLY      : HOLLIS     TRUDY      MICHAEL    LOGAN     
MEGAN      : MARGARITO  MARY       CYRUS      CARROLL    KENT      
JEAN       : ROBIN      DAREN      LUCIEN     FLORINE    PAM        JOHN       DENISE     FREDERICK 
JEAN       : CLINT      RENEE      ROSALINDA 
ROLLAND    : KATY       MONA       CONSUELO   STACIE     CRYSTAL   
STACIE     : LETA       JAY        ROLLAND   
LUISA      : WILLARD    RUDOLPH    DESIREE    EVANGELINE
MITCH      : LOUISE     THADDEUS   GOLDIE     BRANDON   
GOLDIE     : REGGIE     DAREN      MITCH      JOSE      
ELVIA      : MARYELLEN  LUCY       DEBRA      DARYL     
KELLY      : FREEMAN    NITA       MURIEL     BERNICE    VIOLET     OLIN       HIRAM      DEIRDRE   
KELLY      : DESIREE    JUANA      LYNETTE    REGINALD  
HIRAM      : ELVIRA     RANDELL    KELLY      JILL      
PATRICE    : LENARD     VELMA      STEFAN     ALONZO     BRANDI    
GUADALUPE  : RICO       HEATHER    SONNY      CHANCE     TRUMAN     HERMINIA   ED         INEZ      
JED        : SHERMAN    BRIANNA    KAREEM     JEFFEREY  
BRIANNA    : JACQUES    JED        MITCHEL   
WALTER     : MARILYN    SHERRY     MARGIE     LESA       LILLY      ANTONY    
ZANE       : MARGARITO  EDGAR      YONG       DEANN      FERDINAND  RAMON      HERBERT   
EDNA       : JASPER     SOFIA      KATRINA    KATINA    
SOFIA      : AL         GRACE      EDNA       ROSELLA   
RODGER     : NOELLE     FRANCINE   ANGELICA  
LUCIANO    : JAMAL      TYSON      DOUG      
TYSON      : KATHERINE  BERTHA     LUCIANO    DARCY      LOIS      
ROSA       : SANTIAGO   GREGORY    LETA       LUCIA     
LUCIA      : LEANNE     COLEMAN    ROSA       TERRANCE   FRANK     
JANINE     : ROY        AUGUST     REX       
MELISSA    : CAROLINE   LAVERN     SUNG       LUCAS     
SUNG       : JARROD     MELISSA    BENNY     
BETTE      : MONROE     LILIANA    DEWITT     JERALD     RONNIE    
FLETCHER   : RUSSEL     SOPHIA     CHERRY     RHODA      IRENE     
TANIA      : SHAWN      ANNA       REED       ANN        LESA      
TAMMIE     : JOAN       SUSANA    
JOAN       : JOSEPH     WARD       GERARD     LORRIE     TAMMIE     NORRIS     AGUSTIN    JARVIS    
MARCOS     : BEATRICE   CALEB      CARL       ROB       
CARL       : DAMON      TAMEKA     MARCOS     LYMAN      BRANDY    
JOE        : VITO      
VITO       : MARCELLA   JOE        TAMMI      EDWARD    
VALARIE    : AUDRA      ROCKY      KATHIE     HANS       LYNNETTE  
WARREN     : NOELLE     CLEO       LEONARDO   LATASHA    BRAD       COLIN      HARRISON  
BRAD       : JERMAINE   WARREN     OWEN       DORA       ROSEMARY  
CHARLOTTE  : JAMIE      JUNE       DANTE      REX        BEN       
JUNE       : CLAIR      CHARLOTTE  LEE        CHARLENE  
LORENE     : NOEMI      TABITHA   
TABITHA    : CHARLEY    LORENE     GAY        BRADLY     ODELL     
HILDA      : DARREL     MARIANNE   SIMONE    
SIMONE     : HILDA      BRIANA     MARCELO    HERBERT   
KERRI      : ANASTASIA  PRISCILLA  REBECCA    VINCE     
PAM        : CAREY      JEAN       LAKISHA   
IRIS       : DONA       CLAUDINE  
MARGO      : RUFUS      TY         TESSA     
TESSA      : MILLARD    TANISHA    JEANETTE   MARGO      AHMAD      TYREE     
YVONNE     : KARI       VINCE      EARL       ISAAC      VAN       
TERRIE     : IRVING     RICHARD    EMANUEL    JOHANNA   
DIXIE      : PARKER     JACQUELYN  CLARICE   
MIA        : DALE       ELVIRA     MARLON    
KRISTEN    : KENTON     ALI        RUSS      
KENTON     : ALBERTA    LEON       WARD       KRISTEN   
GAYLE      : ANGELA     ISIAH      TERENCE    ARIEL     
SARAH      : TRACY      SANG       AUGUSTUS   KRISTIN    ANGELICA   NED        MASON      ERICH     
BRYANT     : JOAQUIN    RAMON     
IMELDA     : ROBYN      JEFF       OLA        ELTON      LUIS       DEENA     
FREDRICK   : HELEN      VALENTIN   ALBERT    
SHERRY     : WADE       WALTER     NANCY      MURRAY     PRINCE    
IRA        : KERRY      OPHELIA    OCTAVIO    DILLON     DARCY     
CELESTE    : SOPHIE     ALEJANDRO  EUGENIO    DANNIE     LEE        KENYA     
LUCILE     : ESTEBAN    THEODORE   JOSEF      DARIN      MARISA    
MALLORY    : GABRIEL    ROSLYN     GUY        LANCE     
ROSLYN     : HARRY      ABDUL      DOLORES    MALLORY    QUINTON   
ROSCOE     : EULA       CLYDE      LEOPOLDO  
EULA       : ALDO       DERRICK    ROSCOE     JUANA     
REINALDO   : GALE       MARTA      BLAIR      FRANCISCO  SON       
ALPHONSO   : GLEN       JACOB      KERI      
JACOB      : ADELE      ALPHONSO   TERRENCE   BRIANA     KIRSTEN   
IVY        : FAYE       JOHANNA    TERRA     
JOHANNA    : GALE       MATT       JULIAN     TERRIE     IVY        MARI      
INGRID     : LUCY       LYMAN      ROBT       ANTOINETTE CARMINE    BRADFORD  
LYMAN      : ALVARO     ANGELINA   CARL       INGRID     TASHA      CLIFF      BESSIE    
BELINDA    : FOREST     BERTHA     LAUREL     URSULA     ABIGAIL   
JAMEL      : EDWINA     MEGHAN     FRANCINE   EFFIE      RODERICK  
ISAIAH     : IRWIN      LORRAINE  
IRWIN      : DOMINIQUE  TODD       ELMA       TANNER     ISAIAH     DIANNE    
LARA       : SAVANNAH   GLENNA     SUSAN      ERIC       CLAUDE    
PHOEBE     : EUGENIO    FLORA      ROLAND    
MALCOLM    : MARTIN     ETHAN     
ETHAN      : BROOKS     SAMMIE     TOMMY      MALCOLM    STERLING  
HALEY      : LOTTIE     SONIA      KERMIT     MACK      
CHANCE     : EDWINA     LUZ        DORTHY     PATTI      GUADALUPE 
TARA       : NANNIE     BEVERLEY  
DEREK      : FRANCES    HARRIETT   YOUNG      KIM        ELEANOR    STEPHAN    RON       
BETHANY    : KATIE      CRUZ       MICHEAL    AMBER      EDDIE     
MICHEAL    : LORA       BETHANY    ARMANDO    PRINCE     GERRY     
TIMOTHY    : ELVIS      DOROTHY   
ROYAL      : YOUNG      TAYLOR     BRENDAN   
BERNADETTE : ALISSA     EMILY     
ALISSA     : ADAN       RUFUS      DIRK       BERNADETTE
CLYDE      : CHARMAINE  RYAN       GREGG      JAMIE      ROSCOE     STEVEN     CORY       KIMBERLEY 
JULES      : NOREEN     FRANKLIN   STEPHEN    STERLING   BENITA    
LEONA      : LAVERNE    VALENTIN   JORDAN     ALPHONSE   OPAL      
EDUARDO    : DOMINIQUE  JORDAN     TAMERA    
TAMERA     : KRIS       EDUARDO    VIRGIL    
FREDA      : ROSEMARIE  JERROLD    ORLANDO    CLAYTON   
JERROLD    : RAMIRO     REFUGIO    FREDA      HEIDI      EARNESTINE
ERICK      : WYATT      SCOT       LACEY      DARRIN     ROWENA    
LACEY      : JULIA      ERICK      SEYMOUR    MORTON    
HEIDI      : WILLIAMS   JERROLD    CONSTANCE  DINO      
GALEN      : LATONYA    BETTY      ALFONSO    LIONEL     JAYNE     
ALFONSO    : RUDOLPH    GALEN      BERYL     
SHELBY     : TOBY       TRACEY     ABDUL      ETTA       SPENCER    OPAL       PABLO     
SPENCER    : MERLE      DOUGLAS    RAUL       SHELBY     MORRIS     DARCY     
TERESA     : LILIA      KRISTIE    CLAUDINE  
DIEGO      : BILLY      TREVOR     ELSIE      DELORES    RICKIE     TIA        HAZEL     
DELORES    : HORACIO    ELVA       ART        DIEGO     
SHEREE     : STEVE      JARED      DIRK      
ARACELI    : ALYSON     MARCELLA   JOHN      
JOHN       : FEDERICO   TERRI      LAUREN     RUBY       WILLIE     JEAN       ARACELI    MARCI     
JOHN       : WILDA      RON        RIGOBERTO 
OWEN       : MARLIN     BRAD      
LAKEISHA   : SIMON      ANITA      NUMBERS    ANTONIO    STEPHAN    GINO       ROLANDO   
STEPHEN    : JULIETTE   MELVA      JULES      LILLIE    
LILLIE     : VERONICA   KRISTIE    STEPHEN    ELSA      
ERIC       : SOPHIE     GABRIELA   JOHNNIE    LIZZIE     LUANN      LARA       DELBERT    CHARLENE  
ERIC       : ALEJANDRA 
MICHELE    : CONSTANCE  MARCEL    
CONSTANCE  : SALVADOR   ELVIS      HEIDI      MICHELE    STACY     
ELNORA     : PAT        BOBBY     
BOBBY      : DEWAYNE    ELNORA     LUCIO      EVANGELINE ENRIQUE   
NICK       : RUDOLPH    TRACIE     CAITLIN    JANIS      HOPE      
TRACIE     : VIRGIE     NICK       DON       
CASSANDRA  : MARLIN     DIANE      MITCHELL   ROXANNE   
BRANDON    : SHANNA     MITCH      ANGELITA  
ABEL       : WILLIS     STEPHANIE 
DENISE     : WILMA      FRANCINE   JEAN      
JESUS      : LENARD     WENDY      TASHA      KAYLA      ROLANDO   
EVE        : KENNY      MELANIE    BIANCA     FREDRIC    DYLAN     
FREDRIC    : ANASTASIA  MONICA     EVE        ALMA       LAVONNE    ANGELITA  
TRUMAN     : ALONZO     GUADALUPE  CARLO      ALEC      
PIERRE     : PEARL      BEVERLEY  
HUNTER     : ARTURO     MYRTLE     VANESSA    JODI      
SYLVESTER  : LUCIEN     SUMMER     ANNE       CATHY     
STEVEN     : WAYNE      GABRIEL    CLYDE      CHRISTIE   LORENZO    DOLLY     
ANTHONY    : MADELEINE  DINO       RUSTY     
MADELEINE  : RANDOLPH   CLARA      ANTHONY    CAITLIN   
DOMINIC    : JODY       KARL       ROSALYN    MILAGROS  
RAMONA     : LUPE       KRISTI     ANGIE      FANNY      WALLACE    ARIEL     
VINCE      : OLEN       EMERSON    KERRI      YVONNE     LORAINE   
SEYMOUR    : LACEY      MARLENE    LUTHER     VERA      
ALICIA     : TAD        YVETTE     RODERICK  
KAYE       : LEILA      JOEL      
FREDERICK  : BERNADINE  JEAN       WENDELL   
CLIFFORD   : TERRI      WHITNEY    LANNY      DENNIS     NANCY      CHRISTA   
NANCY      : GRAHAM     JARED      JESSIE     SHERRY     CLIFFORD  
AURELIA    : NESTOR     ALISON     CHASE     
ALISON     : JEROLD     AURELIA    JOSIE      CHRISTINA 
DORA       : KRIS       JESSIE     BRAD       BECKY      RANDAL     DEENA     
DORIAN     : LES        SYLVIA    
MICAH      : JODY       KIP        KENDRA     JEROLD     VICENTE   
VICENTE    : MAXWELL    MICAH     
SERENA     : HESTER     KIRK       ISIAH      TOMMIE     JEFFERY    HUNG      
JAMI       : KARIN      VIRGIL     JEFFERY   
KARIN      : WINFRED    JAMI      
SABRINA    : SHANNA     ERNIE      DAMIEN    
ZELMA      : NITA       KATHARINE  BOYD       GABRIELLE  HALLIE     MANUELA   
KATHARINE  : JOHNNIE    ZELMA      JUAN       MARLON     SADIE      VICTORIA  
ERROL      : BETTY      MARGRET    TED        EDDIE      TONY       CHRISTINE 
ELOY       : ASHLEY     FAYE       STUART     LAMONT     PAT       
LESSIE     : PERCY      ANTONE     JIMMY      VERNON     PHYLLIS   
VERNON     : ISRAEL     WANDA      LESSIE     RICHIE    
COLLIN     : GWEN       RONALD     OTIS       PATRICK   
RONALD     : TODD       PHILLIP    COLLIN     MARYANN    RIGOBERTO 
LEE        : TAMEKA     GENA       GREGG      JUNE       CELESTE    EDMUND     HARLEY    
TRINA      : ALVARO     ROSEANN    MAUREEN    LAMAR     
LAMAR      : FABIAN     JENNY      TRINA     
FERNANDO   : DEANNA     ROCHELLE   LORA       MILTON     PAT        PERRY      PHILIP    
LAURIE     : LOTTIE     SALVATORE 
RODERICK   : JAMEL      ALICIA     WILBERT   
WILBERT    : ALEXIS     BRIDGETTE  DOLORES    RODERICK   PAUL      
SHARON     : ERVIN      LATONYA    PANSY      IRMA       MAMIE      STEPHAN    THANH     
KATHY      : DUSTY      NICOLE    
NICOLE     : ROBERT     BETTIE     ELSIE      KATHY      EVAN      
EILEEN     : GREGORIO   JESSE      KENNITH    ROSARIO    RAYMOND   
KENNITH    : JOAQUIN    KATHRYN    MAXWELL    EILEEN     TRICIA     LESLEY    
MILDRED    : MARVA      TERENCE   
TERRANCE   : JULIO      ADAM       LUCIA     
DARRIN     : RICO       KORY       JOHNIE     ERICK     
JANIE      : DONNA     
JEANNETTE  : VALERIE    DEE        JAMIE      LEILA      JEFFEREY  
OLIVIA     : SUSIE      MAURA      CRAIG      SHANNON    PATTY     
SHANNON    : LISA       TRACEY     ABDUL      ALBA       OLIVIA     ELISE      ALLAN      MARYANN   
SHANNON    : SCOTTIE   
RUTH       : SHAWN      KATELYN    WILLARD   
WOODROW    : ODESSA     VALENTIN   IRENE     
OTTO       : JEWEL      ROSARIO    AIMEE      RODOLFO    ANIBAL    
KELSEY     : BONNIE     KRISTINA   NUMBERS    FRAN       ANNABELLE 
PATTY      : OLIVIA    
ESTELA     : ALEXANDRIA WANDA      ANTONIO    LAVONNE   
ANTONIO    : GENEVA     ROSANNA    LAKEISHA   ESTELA    
DARYL      : VINCENT    ELVIA     
JERALD     : DUSTY      KIM        BETTE     
HOWARD     : GARTH      ISSAC      MORTON     ALVIN      AMANDA     MARISSA   
ISSAC      : FLORENCE   HOWARD    
CHRISTIE   : LEVI       STEVEN     ANGELICA  
AMBER      : TANISHA    BRADLEY    BETHANY    KENT      
CANDY      : EDWIN      DEE        HERMAN    
BENJAMIN   : RONDA      RONNY      CECILIA    NAOMI      SANTOS     CONNIE    
CECILIA    : TRISHA     OPHELIA    TYRONE     BENJAMIN   SHELIA    
NELDA      : ROBERT     RANDOLPH   QUINN      ALISHA    
JOEY       : BARTON     RACHEL     HELEN      MORRIS     FOSTER    
MORRIS     : MARCELINO  HELEN      BOOKER     SPENCER    JOEY       GERALD    
KATRINA    : HORACIO    JIM        BILLIE     EDNA      
VIRGIL     : CONRAD     BONNIE     TAMERA     JAMI       BLAIR     
ROSARIO    : JULIO      GERALDINE  EILEEN     OTTO       KRISTOPHER LOUELLA    CHASE     
SIDNEY     : MARION     JORDAN     JOSEFA    
RUTHIE     : ANGELA     CELIA      CARLENE    REGINALD  
IAN        : TORY       SEBASTIAN  JAIME      DARIUS     CONCEPCION
MARGUERITE : NADIA      DOROTHY   
DEIDRE     : DARRYL     RACHELLE   CAITLIN    CLAUDE     JUANITA    BRIANA    
CAITLIN    : ALVA       STEVE      ROSE       NICK       MADELEINE  DEIDRE     GEORGIA    EARLINE   
MERCEDES   : VERONICA   COY        LAVERN    
SHEENA     : REBECCA    RORY      
JOSIE      : VALERIE    ALISON     GERMAN     LLOYD      DAMIAN    
GERMAN     : AMALIA     SONNY      JOSIE     
DEIRDRE    : MARILYN    WINNIE     KELLY      ALPHONSE   ABIGAIL    MANUEL    
RICHIE     : DEANNA     VERNON     THERESA   
JAIME      : PETER      DEBORA     BRIDGETT   IAN        HOLLIE     ELDON      FLOSSIE   
HOLLIE     : BERTA      BENNIE     JAIME      HENRIETTA 
KRISTOPHER : AILEEN     IGNACIO    ROSARIO    JOHNATHAN  GLADYS    
JONAH      : MILLARD    ROSEMARIE  KRISTIN    GENEVIEVE 
KRISTIN    : JASPER     SARAH      JONAH      MARIANA   
REYNA      : MINNIE     DELLA      ROSALIND   LEIGH      RALPH     
JANIS      : COREY      JAMAL      NICK       JERRY      FRANCISCO 
JERRY      : JANIS      KRISTA     MOSES      PHIL       PEDRO     
AUDREY     : CHARLIE    EMMETT     LESLEY     REYNALDO   ALTHEA    
BOYD       : KATIE      ZELMA     
ANNIE      : TERRY      KIRBY      MERLE      MARIANNE   MARCY     
RAMON      : ESTEBAN    GARLAND    ZANE       BRYANT    
ABRAHAM    : MARQUIS    TRICIA     ALFONZO   
TRICIA     : KENNITH    ABRAHAM   
SANDRA     : CLEO       DANA       MARIETTA   ELI       
BERNARD    : MONROE     HECTOR     PETER      ROBERT     EDWARDO   
NORRIS     : JOAN       ENID      
WESTON     : LAWRENCE   RICK       KERMIT    
MAX        : PEARL      KAREN      CAROLINA   KEVEN      CARMELO   
TRENT      : DEAN       GIL        JENNY      GEORGIA    CANDACE    JOESPH    
GEORGIA    : ANNETTE    CAITLIN    TRENT      LOU        DEANNE    
ELDON      : JAIME      LEONOR     BLANCHE   
LEONOR     : LELAND     ELDON      CHERI     
OLA        : LEANNE     IMELDA     EVANGELINE
LOU        : GEORGIA    CECILE     GINGER    
ALEXANDRA  : ZACHERY    CLAUDE     FELIPE     ELIAS     
CLAUDE     : IRVING     BERNARDO   LARA       DEIDRE     ALEXANDRA  VERN      
MARI       : BARRY      ELVIRA     BRUCE      JOHANNA   
RAQUEL     : ILENE      WILLIAMS   CLIFF      GERRY     
JONI       : MARIA     
JEFFERY    : DEMETRIUS  DERRICK    SERENA     JAMI       ROSENDO   
ELEANOR    : SHANNA     ELMO       DEREK      MADELYN   
MARIANA    : MIRIAM     KRISTIN    BOBBIE     AIMEE      HILLARY   
KIETH      : DELORIS    JOANNE     GILBERT    CHRISTIAN  CONCETTA   TOMAS      EVA       
ALMA       : SASHA      HARRIETT   FREDRIC    RONNIE    
EARLENE    : DAISY      ANGEL      MURRAY    
GAY        : MILTON     TABITHA    TOM        ANTOINETTE IDA       
KRISTA     : DARWIN     JERRY      SONDRA    
ELTON      : MEGHAN     LORA       BRANDIE    IMELDA     LUCINDA    BRENTON    LAURA      EVANGELINA
ROSEMARY   : TAYLOR     DEMETRIUS  BRAD       ESSIE      JOY       
LEANNA     : KIRBY      MATHEW    
ERNESTO    : LATASHA    WILLIE     MINERVA   
MINERVA    : SHELTON    ERNESTO    ANGELICA  
RILEY      : LAUREN     BRUNO      RENEE     
ERIK       : JASON      DARWIN     RUFUS      CYRUS      NOLA      
LANA       : JEANNIE    FLORA      DARREN    
FANNY      : POLLY      ANDREA     DUSTIN     RAMONA     LLOYD      ALYSSA     MARTINA   
CATHY      : SYLVESTER  CHRISTI   
CHRISTI    : KENNY      NOEMI      CATHY     
REUBEN     : CARISSA    LATASHA    STEPHANIE  SYBIL     
STEPHANIE  : JUDITH     ULYSSES    ABEL       REUBEN    
CLARK      : MOHAMMED   CAREY      NOAH       ROBBY     
NOAH       : DORTHY     CLARK      PAIGE      DEANNE    
HERMAN     : CANDY      ANA        GABRIELLE  GRETCHEN  
ANA        : MATTIE     EFFIE      HERMAN     WILDA      NICHOLAS  
COLBY      : LUPE       KRIS       CRISTINA   HELENE    
JONATHON   : MICHAEL    YONG       ALLISON    MORTON    
ALLISON    : CORA       PATRICIA   JONATHON   ELINOR    
MARINA     : JAMAAL     KRISTIE    JANNIE    
TED        : SANG       MARYELLEN  ERROL      GERALD    
FLORA      : PHOEBE     LANA       STERLING   JANA      
STERLING   : NIGEL      RANDOLPH   ETHAN      JULES      FLORA      BRICE      MARC       EFREN     
CHRISTA    : JAMAL      HARRY      GORDON     CLIFFORD   IVA        PABLO     
IVA        : DARWIN     WILLARD    CHRISTA    TYREE     
LUELLA     : JEROME     VIOLET     JAYNE      LYNDA     
OTIS       : COLLIN     CATHERINE  DEANNE    
CATHERINE  : OTIS       DESIREE    MADGE     
KATHIE     : VALARIE    BURL       NELSON     FRAN      
BURL       : ALISA      PATRICIA   KATHIE     LAKISHA   
MORTON     : BRANDIE    MARION     LETA       LACEY      HOWARD     JONATHON   BETTYE    
DAPHNE     : ROY        STUART     DESIREE   
DESIREE    : PERCY      LUISA      KELLY      CATHERINE  DAPHNE     CORNELIUS 
JUAN       : VERNA      MARION     KATHARINE  LILIAN     LYNNETTE   GENEVIEVE  LAZARO     ALEX      
GUSTAVO    : THOMAS     ELMA      
PAUL       : WILBERT    LAKISHA    DANNY     
LAKISHA    : CHRIS      DANNIE     RYAN       PAM        BURL       PAUL       PATRICA   
DILLON     : DEANN      IRA        CONNIE    
DIANN      : WHITNEY    JOSH       PERCY      VANCE     
LEOPOLDO   : ROSCOE     EDDIE     
RONNIE     : RODRIGO    BRET       BETTE      ALMA       WILEY      CATALINA  
ROSALIND   : DAWN       LANNY      BILLIE     REYNA      DIANA     
MIKE       : ALISA      NAOMI     
NAOMI      : BENJAMIN   MIKE      
NATHANIEL  : JUDITH     ADRIAN     JEWELL     FREDDY     JERROD    
EARNEST    : RACHAEL    LEWIS      HILLARY   
WALDO      : DEANN     
KAREN      : MELVA      TANYA      CHARLES    MAX        JEFFREY   
PAULA      : DONA       ROB        KATHRINE   DARREN     LELA      
ELISEO     : SHARLENE   TIFFANY    BLAINE    
LUCIO      : CHRYSTAL   JENNIE     BOBBY      JOLENE    
JOLENE     : ANDRES     JACKIE     YOUNG      MARIA      LUCIO      LORAINE   
MARCO      : DAVIS      BERRY      REX       
THURMAN    : CASEY      MABLE      PHILLIP    TAMIKA    
SHELIA     : NITA       MELINDA    ROMEO      CECILIA   
AMY        : MARY       JORDAN     DAVID      CODY      
NATALIA    : REBEKAH    AUDRA      DOREEN     JORGE      GUS        HILLARY   
DONOVAN    : DENNIS     VILMA     
LEIGH      : ELLA       KIM        FAYE       CHRISTOPER REYNA      DONNIE    
HILARY     : JIMMIE     TREVOR     EMILIA     MIGUEL    
ANGEL      : KARL       CRISTINA   ROSANNA    EARLENE    ESTHER     EMILY     
LOYD       : HENRY      PANSY      REBECCA    ANTONIA    GROVER    
AMADO      : ADRIAN     GALE       MONA       DEANDRE    COY       
AGUSTIN    : DOMINIQUE  JILLIAN    CHRISTIAN  JOAN       AHMAD      ALAN       BRITNEY   
ORLANDO    : GUILLERMO  FREDA      PRESTON    JOEL      
WALLACE    : VERNA      RANDELL    RAMONA     NEWTON    
CHARITY    : BONNIE     LOREN      SHERMAN    EBONY      CLARICE   
DIANNE     : LAWANDA    IRWIN      AVA       
ROWENA     : JODY       KATHERINE  ERICK      KYLE      
MOSES      : LAWRENCE   CESAR      JERRY      KATINA    
ROB        : DONNELL    GRACE      MARCOS     PAULA      ALAN      
MARITZA    : IRVING     GINO      
ELMER      : RHODA      DARNELL   
ANGELINE   : KIRK       WENDY      LULA      
SUSANA     : MARIA      JEREMY     TAMMIE    
STEWART    : MARIA      TAMARA     PANSY      SHANE     
MARLON     : EUGENIA    JUDY       ISABELLA   MIA        KATHARINE  TAMI       SHERRIE   
ROSENDO    : FREEMAN    JODY       JEFFERY    TREY       ELLIOT     WILLA      ROSALYN   
CAROLE     : ELVIS      LAMONT     HOPE       ELISE      ETHEL     
TERRA      : ADRIANA    IVY        LYNNE     
HUGO       : VICKY      VERONICA   PAIGE      BLAINE    
LULA       : MATTHEW    ANGELINE   MADELYN    SHERRI    
CLINT      : HECTOR     ANTON      BIANCA     JEAN      
BLAIR      : HEATHER    REINALDO   VIRGIL     RAY       
HANS       : AMALIA     CHRISTIAN  VALARIE   
JARRED     : DARWIN     WILLIE     CLAUDIO   
BERTIE     : ERICA      CRAIG      RALPH      ROLANDO   
RALPH      : GWEN       ALANA      REYNA      BERTIE    
MYRON      : ULYSSES    JAY        MAI       
MILLIE     : CHRIS      MERLE      SAMANTHA   LORRIE     MILFORD   
TREY       : GILDA      ADELE      COCO       ROSENDO   
BOBBIE     : JASON      ASHLEY     SHARLENE   ALFREDA    MARIANA   
MELVIN     : FAYE       TYRONE    
URSULA     : JORGE      ALBA       BELINDA    CYRUS     
SEAN       : JOHNNIE    BILL       JACLYN     GUS       
QUINTON    : DANNIE     ROSLYN     NELL      
DODO       : VICTOR     ALFREDO    LINCOLN    ALANA      ROBBIE     MAI        RON        DERICK    
DODO       : MILAGROS  
LIDIA      : STEVE      TRUDY      KELVIN    
WELDON     : CRUZ       SHAUNA     CASANDRA   HARVEY     RENA      
TASHA      : LESLIE     LYMAN      JESUS      VICKIE     DEBORAH   
VICKIE     : GEOFFREY   NUMBERS    CORINE     TASHA      NICOLAS   
CAROLINA   : MAX        KAREEM     AIMEE      MILO      
KAREEM     : VALERIA    JED        CAROLINA   CHERI     
LILIAN     : LOLITA     JUAN       LANDON    
JANA       : MARVA      LORI       ROCKY      FLORA      CARTER    
SHANE      : SHELLEY    LEAH       ANGELO     STEWART    BRIANA     BERNIE    
MARCI      : KORY       JOHN       ARLINE     LENNY      THERON    
JUANA      : RUFUS      RANDI      KELLY      EULA       ROBBY     
RAY        : AIDA       RANDY      BLAIR      MYLES      RENEE      DANIELLE  
OLIVER     : JUSTIN     THERESA   
JUSTIN     : GWEN       OLIVER     AUGUSTA   
TYLER      : SHIRLEY    RYAN      
AUGUSTA    : GRACIE     NOLAN      JUSTIN    
NORBERTO   : ARCHIE     MERLE      DORTHY     MILFORD   
CECILE     : DOLORES    LOU        IRENE      LESTER    
IRENE      : TORY       FLETCHER   WOODROW    CECILE     RICH       LUCILLE    ERICH     
NICOLAS    : AIDA       LINDA      VICKIE     CORNELIUS  LON        VAUGHN    
DELBERT    : SHELDON    JEREMIAH   ERIC       ALEJANDRA  FANNIE    
LYNNETTE   : HERSCHEL   ROSALIE    VALARIE    JUAN       HOPE       BEN       
HOPE       : NICK       CAROLE     LYNNETTE  
ELISE      : DEON       BARNEY     SHANNON    CAROLE     MAUDE     
FELECIA    : LAWRENCE   LIZZIE     BRIDGETT   SCOTTY    
LIONEL     : JACQUELYN  GALEN      THELMA    
VIRGINIA   : HANNAH     BROOKE     ALBERTO   
JARRETT    : OPHELIA    LEVI       DUSTIN     JACK      
BUDDY      : NATALIE    FERN       CARSON    
AIMEE      : OTTO       MARIANA    CAROLINA   ANTOINE   
BROOKE     : JULIETTE   JORGE      TOMMIE     VIRGINIA   ABBY      
GERALD     : STELLA     FORREST    MORRIS     TED        JAYNE      ALYSSA    
BONITA     : NONA      
MEREDITH   : JACKIE     CHANDRA    REED       GENE      
MARIO      : ALVARO     MARGRET    KURT      
CARLOS     : MATT       JON        CARLY     
BENNY      : EMERY      EMILIA     SUNG       LARRY      JEANNINE  
LARRY      : BILLY      TRACEY     BENNY     
CLARICE    : KATHLEEN   DIXIE      CHARITY    CASANDRA  
CASANDRA   : WELDON     CLARICE    BURT       BRIANA    
ARMANDO    : ALBERTA    MICHEAL    FELICIA    RICKIE    
BRANDY     : EFFIE      CARL       CANDACE    VAUGHN    
BRICE      : KIP        DEANNA     STERLING   JACK       MILLICENT  ROYCE     
ALBERTO    : KARL       FAY        WESLEY     TERENCE    VIRGINIA   EFRAIN     KURT      
CYRUS      : THADDEUS   KENNETH    CARLA      MEGAN      ERIK       URSULA    
DANTE      : PARKER     ELISA      CHARLOTTE 
AMIE       : SUZETTE    NEAL      
SUZETTE    : AMIE       OSVALDO    ELIAS      AMOS      
RICH       : ADRIENNE   FRITZ      IRENE      CALLIE     YESENIA   
KERMIT     : WAYNE      SHARLENE   HALEY      WESTON     SHAWNA    
PAIGE      : ALINE      JOHNATHON  BOB        NOAH       HUGO      
MARCY      : FEDERICO   RAMIRO     SHANNA     ANNIE      DAVE       CASSIE    
ALI        : RACHAEL    ADRIANA    KRISTEN    CATHRYN   
GRADY      : POLLY      LONNIE     LYNETTE    ALYCE      LINWOOD    KURTIS    
LYNETTE    : TRACEY     MONTY      KELLY      GRADY      VERN      
NICKOLAS   : SHELLEY    FRITZ      KARLA     
KYLE       : KERRY      ROWENA     GABRIELLE 
GABRIELLE  : EMILE      ZELMA      HERMAN     KYLE      
PETE       : AARON      JAMAR      DEANNE    
GENEVIEVE  : LUCIEN     DANA       NESTOR     JONAH      JUAN      
JUANITA    : JAMAL      LINA       DEIDRE     DWIGHT    
ALVIN      : JUSTINE    JANETTE    HOWARD     ERNIE     
ERNIE      : SABRINA    ALVIN      BART      
EVANGELINE : DEON       TRACY      LUISA      BOBBY      OLA        WILTON    
ALLAN      : DAMON      SHANNON    LESLEY     FRAN       LLOYD      VONDA      VERA      
CLAUDINE   : BERNICE    ODIS       IRIS       TERESA    
JOCELYN    : STACEY     MURIEL     NICHOLAS  
NORBERT    : SEBASTIAN  TRENTON   
TAMI       : MOHAMED    MATTIE     MARLON    
JACK       : JARRETT    BRICE      ISMAEL     ELIZA     
ESSIE      : NITA       LATISHA    JEFF       MARIETTA   ROSEMARY  
MAMIE      : CASEY      RONDA      SHARON     MARLENE   
JANNIE     : EDGAR      MAURA      MARINA     HARRIS    
SALLIE     : GABRIELA   FERN       HENRIETTA  SHERI     
HENRIETTA  : LETICIA    COLLEEN    HOLLIE     SALLIE     RODNEY    
SUE        : JACKIE     EMILE      CHARLENE   ROGELIO    LINDSAY   
HERMINIA   : AUBREY     WARD       GUADALUPE 
RODRICK    : MARILYN    PHYLLIS   
ISMAEL     : RENE       JEANIE     JACK       TERI       ANN       
TERI       : FRANCES    NOREEN     ISMAEL    
MAI        : MYRON      DODO       CLEVELAND 
EUNICE     : EMMETT    
EMMETT     : RENE       GARRY      AUDREY     EUNICE    
MARCUS     : AIDA       PRISCILLA 
BERYL      : LOTTIE     POLLY      ALFONSO    MILFORD    MORGAN    
MILFORD    : SEBASTIAN  MILLIE     NORBERTO   BERYL      LOURDES   
NEIL       : ARTHUR     FELICIA   
COLIN      : VALENTIN   WARREN     ELENA     
ELENA      : ROBIN      COLIN     
MARSHALL   : ROBERT     THAD      
THAD       : HECTOR     DOUGLAS    RAUL       MARSHALL  
DWIGHT     : LILIANA    JUANITA    KITTY     
FELIPE     : COLE       STACEY     MAE        SCOT       ALEXANDRA  RUSTY     
ANGELICA   : APRIL      CLARA      RODGER     SARAH      CHRISTIE   MINERVA    CLAUDIO    AUSTIN    
MURRAY     : CHRIS      SIMON      CONSUELO   DARREL     JASPER     SHERRY     EARLENE    MAC       
MURRAY     : ISAAC     
VILMA      : EUGENIA    NETTIE     DONOVAN    EARNESTINE
PEGGY      : AUGUSTINE  DAISY      GUY       
GUY        : EBONY      MALLORY    PEGGY      STACY      DOMINICK   DYLAN      HARLAN    
DIANA      : ROSALIND   DAVID     
ANN        : MICHAEL    TANIA      ISMAEL     THERESA   
PRESTON    : ORLANDO    DOMINICK   DELMAR    
CANDACE    : CYRIL      TRENT      BRANDY    
LORENZO    : BILLIE     STEVEN     KATINA    
CLARENCE   : JACKSON    CRAIG      LUTHER     DELMER    
JO         : LOUISA     NOEMI      ALYSON    
CORY       : ANNE       CLYDE     
WENDELL    : EMANUEL    DENNY      FREDERICK  ALICE     
ALICE      : FLOYD      BRYCE      WENDELL    DANNY      CLAUDETTE 
NED        : BETTIE     ADRIENNE   ELISA      SARAH     
MARIE      : PRISCILLA  CLIFF     
CLIFF      : QUENTIN    DEMETRIUS  LYMAN      RAQUEL     MARIE     
EVAN       : DANE       DENA       NICOLE     ESTHER     ELI        EVERETT    PETRA     
ESTHER     : PHILLIP    ANGEL      EVAN      
SAMUEL     : JULIETTE  
DAVE       : KENDRA     JUNIOR     MARCY      KURTIS    
DEVIN      : SHAWN      FERDINAND  WILEY     
KATINA     : EDNA       MOSES      LORENZO    ABIGAIL   
MARLENE    : KENDRICK   SEYMOUR    MAMIE      ROLAND     PAULETTE  
ROLAND     : ERICKA     JANE       PHOEBE     MARLENE   
TRAVIS     : LOUISA     CURTIS     PHILIP     REYNALDO   MINDY     
TERRENCE   : EARLE      SUMMER     JACOB      DYLAN     
EDMUND     : PAMELA     LEE       
ANTONIA    : CONRAD     STANLEY    SHIRLEY    LOYD       TONYA     
ALYCE      : LEOLA      EUGENIO    GRADY     
ELINOR     : ERICA      ALLISON    JOSIAH     ROXANNE    MYRNA     
JOSIAH     : SAMMIE     ELINOR    
FRIEDA     : AL        
GERTRUDE   : HENRY      HOUSTON    AGNES     
LAVONNE    : FREDRIC    ESTELA    
BART       : COLEEN     JACKSON    WYATT      ERNIE      ABBY      
ROBT       : ARLENE     INGRID     MARQUITA  
FELICIA    : MERLE      CARMEN     JONATHAN   KELLI      KRISTIE    JAY        ARMANDO    NEIL      
ILA        : ELLA       CORRINE    INA       
INA        : SHELDON    BOBBI      ROBERT     JAMIE      ILA       
LUCINDA    : GEORGINA   LOWELL     ELISA      ELTON     
CHARLENE   : BERTHA     GAIL       JUNE       ERIC       SUE       
ROXANNE    : STACEY     LANE       BEAU       DOLORES    CASSANDRA  ELINOR     LINDSAY   
GLORIA     : CHERRY     EDDIE      FRANCISCO  MARQUITA  
EDDIE      : DANA       MARY       CRAIG      BETHANY    ERROL      LEOPOLDO   GLORIA    
CARLENE    : ORA        VERONICA   RUTHIE     DAMIEN     CARSON     MARYLOU   
DAMIEN     : ALBERT     SABRINA    CARLENE    PHILIP    
DINO       : GEORGINA   JIMMIE     FRANCESCA  HANK       HEIDI      ANTHONY   
ALPHONSE   : WILMER     LEONA      DEIRDRE   
PATSY      : MORGAN    
MORGAN     : GILBERTO   CHELSEA    LINDSEY    BERTA      BERYL      PATSY     
SYBIL      : GARLAND    REUBEN    
MALINDA    : BEVERLEY   KASEY      HERIBERTO  ANDERSON  
OSVALDO    : LESLIE     SUZETTE    ANDERSON  
RICKIE     : KIM        DIEGO      ARMANDO   
RICKY      : NOELLE     EDWINA    
LAZARO     : JUAN       FRANKIE    CARLTON    ROSS      
CURTIS     : JIMMIE     LULU       ERICA      TRAVIS     NELL      
SHAWNA     : CAREY      NETTIE     KERMIT    
TAMMI      : ODIS       ANDREA     VITO       MAC        AMELIA    
MAC        : IRVIN      MURRAY     TAMMI      ROSS      
EARNESTINE : JEANIE     ANGELIA    JERROLD    VILMA      DALLAS    
DALLAS     : BERNADINE  JENNIFER   EARNESTINE MILO      
NORMA      : ELIZA      IDA        REBA      
ELIZA      : STELLA     CAMILLE    JACK       NORMA      ROSALYN   
MYLES      : RAY        DEVON     
MAGDALENA  : DWAYNE     PASQUALE   FRANKIE    SHAUN      ELVIN      REYNALDO  
PASQUALE   : DANIEL     YOUNG      MAGDALENA  JAVIER    
BURT       : JACKSON    LAVERNE    MARION     CASANDRA   HUNG      
MADGE      : JAY        CATHERINE 
ROSELLA    : DUSTY      KIMBERLY   CHARLEY    SOFIA     
ALTON      : BENITO     FREDERIC   BUD       
RITA       : BERTA      CHARLES    EDITH      STACY     
STEPHAN    : GONZALO    MARLIN     DEREK      LAKEISHA   SHARON    
MAVIS      : JULIO      KATELYN    RONDA      BENNIE    
EFRAIN     : GLENN      ALBERTO   
TAMRA      : IMOGENE    MARILYN    SHELLY     DARIN      JACQUELYN  FELIX     
NEWTON     : SUSANNA    SUZANNE    LAURENCE   WALLACE    RHONDA    
DARNELL    : JULIO      ROBIN      DEBORA     YOLANDA    ELMER     
GINO       : GLEN       LAKEISHA   MARITZA   
CARLO      : DAREN      DALTON     SOLOMON    TRUMAN     JAVIER    
PATRICA    : BARBRA     MAXWELL    JORDAN     LAKISHA   
MIGUEL     : LIZA       HUGH       FIDEL      HILARY    
KEVEN      : MAX       
DARIO      : ADAM       PERCY      DALTON     MAURA      GARY       CECIL     
GARY       : CESAR      DARIO      EFREN     
FOSTER     : ODESSA     DOREEN     JOEY       EARLINE   
CLAUDIO    : TAYLOR     CONCETTA   JARRED     ANGELICA   MARGERY    ALTHEA    
MICKEY     : ANGELA    
ALEC       : KATIE      CORNELL    BRADY      TRUMAN     ABE       
QUINCY     : GENARO     TRENTON   
CARROLL    : SUSAN      BRENDA     ULYSSES    MEGAN      ROBERTA   
STACY      : MAURA      HERIBERTO  CONSTANCE  GUY        RITA       DEBBIE     DOMINICK  
DEBBIE     : RAFAEL     STACY      REID       SADIE     
HAROLD     : CARA       CELIA     
MARTHA     : ELLIS     
FRANCISCO  : REINALDO   JANIS      GLORIA    
BRIANA     : VICTOR     SIMONE     JACOB      DEIDRE     SHANE      CASANDRA  
HALLIE     : EMERY      ZELMA     
DARCY      : LOUIE      TYSON      IRA        SPENCER   
CORINNE    : WILFRED    JOSUE      TIM        WARD       DOROTHEA  
KATHRINE   : ERMA       MARA       PAULA      JENNA     
VERN       : CLAUDE     LYNETTE    JILL      
NOEL       : FRANCES    JOAQUIN   
JOY        : FRANCIS    ROSEMARY  
LESTER     : GEOFFREY   GILBERT    CECILE    
TIA        : DORTHY     TREVOR     DIEGO     
TWILA      : MEGHAN     SHIRLEY   
JEFFERSON  : REGGIE     ERNESTINE  EDITH     
ZACHARIAH  : SOPHIE     ORA        LEVI       MARCELLA  
BERRY      : KERRY      MERLE      FLORINE    MARCO     
EARLINE    : CESAR      RUBY       CAITLIN    FOSTER     PATRICK   
DEANNE     : GEORGIA    NOAH       OTIS       PETE      
AMANDA     : MICHAEL    RONDA      GORDON     HOWARD     JENNA     
NELSON     : GREGORIO   GEOFFREY   KATHIE    
ALEJANDRA  : ANDRE      TAYLOR     ERIC       DELBERT   
LOIS       : SYDNEY     ROMEO      CATHLEEN   TYSON      LETHA     
TONY       : NAPOLEON   ERROL      MAJOR     
RHONDA     : JOANNE     MARION     NEWTON    
ANDERSON   : THOMAS     DEWITT     DENNY      MALINDA    OSVALDO   
CHRISTINE  : LYLE       BIANCA     ERROL      ESPERANZA  REVA      
ESPERANZA  : CHRISTINE  PEARLIE   
LEO        : APRIL      ERIKA     
MITCHEL    : LYNN       EMANUEL    BERTHA     BRIANNA   
ELI        : CANDICE    SHAWN      SANDRA     EVAN      
EMILY      : JANET      ERNEST     BERNADETTE ANGEL     
KENT       : MEGAN      AMBER      ARLINE    
ARLINE     : MARCI      KENT       ELIAS     
DEBORAH    : TASHA      MARGIE    
MARGIE     : WARD       WALTER     DEBORAH    CHAUNCEY   FRANKIE   
NOLA       : ERIK       FAITH     
FAITH      : JEANIE     NOLA      
BLANCHE    : MELANIE    ABDUL      ELDON     
BRENTON    : VALENTIN   ELTON     
PHIL       : LAMONT     JERRY     
BESSIE     : ROMAN      TY         LYMAN     
BEATRIZ    : BRANDI    
DEVON      : MYLES      PEARLIE   
PEARLIE    : LELIA      DARREL     ESPERANZA  DEVON      DOMINICK  
TISHA      : LUPE       MERLIN     GAIL       TAMIKA     EMMA       ALAN      
CHAUNCEY   : JOSEPH     DUSTY      MARGIE    
MASON      : LEON       LUCY       SARAH      ROBERTO    LAURI     
RUSTY      : NIGEL      BETTIE     ANTHONY    FELIPE    
KAYLA      : RAMIRO     BERTA      LEILA      JESUS     
ROOSEVELT  : OLLIE      PENELOPE  
TAMIKA     : HOMER      STANLEY    GARRETT    THURMAN    TISHA      CARTER    
JANELLE    : CLINTON    DARREL     OLIVE     
LESLEY     : DOMINIQUE  HOMER      LINCOLN    KENNITH    AUDREY     ALLAN     
JILL       : DION       THERESE    PANSY      HIRAM      VERN      
TERRELL    : JOSEFINA   CONCETTA  
CLEVELAND  : ALDEN      JANETTE    MAI       
PHILIP     : ARTURO     WHITNEY    HOLLIS     DEANNA     CHELSEA    FERNANDO   TRAVIS     DAMIEN    
KELLIE     : LIZA       MICHEL     KRISTY     LORA       TANISHA    CATALINA  
LENA       : TOMAS     
TOMAS      : LIZA       KIETH      LENA      
EARL       : GIL        YVONNE     FRANKIE   
FRANKIE    : TRACEY     DARREL     KAITLIN    REBECCA    LAZARO     MAGDALENA  MARGIE     EARL      
FRANKIE    : MYRNA      LATOYA     EMORY     
DAVID      : AMY        DIANA      SHAUN      ERWIN      LILY      
SHAUN      : MAGDALENA  DAVID     
VIOLA      : HERSCHEL   MITZI     
ORVILLE    : ADAN       ELWOOD    
WILDA      : CHASITY    JOHN       ANA       
SARA       : JEFFRY    
JEFFRY     : KAITLIN    SARA      
REGINALD   : JENNIE     TERENCE    MARY       KELLY      RUTHIE     AVIS      
SONDRA     : LYNN       CASEY      KRISTA     MONTE      SAL       
MONTE      : GRACE      ISABELLA   SONDRA    
CLARE      : YOUNG      NANNIE     ROMEO      AHMAD      CODY      
DARIUS     : IAN        LUKE       SHARRON   
LUKE       : LYNN       FRANCES    JESSICA    JULIETTE   DARIUS    
JENNA      : KATHRINE   AMANDA     THANH      CATALINA  
ELLIOT     : CATHLEEN   DAISY      ROSENDO   
NICHOLAS   : MISTY      ANA        JOCELYN   
LENNY      : LORI       WILLIS     EMANUEL    MARCI      JEANNINE  
CLAIRE     : YVETTE     LINWOOD    CHUCK     
LINWOOD    : GRADY      CLAIRE    
GRETCHEN   : ROBIN      HERMAN     RANDAL     OMAR      
LUTHER     : NIGEL      SEYMOUR    CLARENCE   DENIS     
AUSTIN     : CHASITY    ZACHERY    ANGELICA  
CARLTON    : MARGARITA  ALONZO     LAZARO    
KURT       : LELAND     CARA       MARIBEL    MARIO      ALBERTO   
HELENA     : FRANCIS    LEANN      THELMA    
LESA       : KRISTI     WALTER     TANIA     
DOROTHY    : LELAND     TIMOTHY    MARGUERITE JESS      
BETTYE     : MORTON    
AHMAD      : TESSA      AGUSTIN    CLARE     
ADELA      : HOLLY      RAFAEL     ULYSSES    THERON     RENA      
CYNTHIA    : CLEMENT    EFREN     
BUD        : CALVIN     JENNY      ALTON     
JERRI      : ALFRED     GLEN      
ENID       : KIP        NORRIS    
PRINCE     : FRANCISCA  BORIS      SHERRY     MICHEAL    KARYN     
TIFFANY    : DEE        CLEMENT    ELISEO    
THERON     : MARCI      ADELA      LUIS      
KURTIS     : EDGAR      GRADY      DAVE       MAYNARD   
MARICELA   : NATASHA    EBONY      LESLIE    
RUSS       : KRISTEN    ANTONY    
ISAAC      : YVONNE     MURRAY     DYLAN     
EMMA       : ERICA      TISHA      LORAINE    KARINA    
LORAINE    : MARYELLEN  VINCE      JOLENE     EMMA       AVA       
NEAL       : CONCETTA   AMIE      
TIMMY      : ROBIN      FRANCESCA  ORVAL     
MAURICE    : RAE        GERARD     ANDY      
CALLIE     : MAE        RICH       AVIS      
HUNG       : SHAUNA     SERENA     BURT       ELISABETH  MILLICENT 
LANCE      : MALLORY   
MILO       : ISIAH      ADOLPH     CAROLINA   DALLAS    
CHERIE     : JOSH       MAURICIO   FRAN      
FRAN       : KELSEY     KATHIE     ALLAN      CHERIE    
THELMA     : ALEXIS     MARLIN     LIONEL     HELENA    
CASSIE     : FREDDIE    RANDI      MARCY      MACK       KELVIN    
CLARISSA   : HELGA      MONA       NOEMI      ANDRE      ROMAN      COURTNEY  
DON        : COURTNEY   TRACIE    
THERESA    : ELVIRA     CURT       RICHIE     OLIVER     ANN       
LOURDES    : MILFORD   
XAVIER     : LESLIE     GERARD     JESSE      TOM        KERI      
TOM        : SHERMAN    GAY        XAVIER    
ELISABETH  : HUNG       LEWIS      BRITNEY   
LEWIS      : EARNEST    ELISABETH  ARON      
ABIGAIL    : ANTON      HATTIE     BELINDA    DEIRDRE    KATINA     JAN       
BENITA     : CHRISTIAN  JEREMY     JULES      PAULETTE   CARRIE    
REVA       : EDDY       PAULINE    CHRISTINE 
DELMER     : CHRIS      JON        STUART     PERRY      CLARENCE  
HELENE     : MARVA      COLBY      ALTHEA    
HARVEY     : ISRAEL     SUSANNA    FRANCES    COREY      WELDON    
WILLIAM    : TERRY      CAMERON    ANDY      
NELL       : SASHA      KRISTIE    QUINTON    CURTIS     HAZEL     
OPAL       : BOBBI      REED       LEONA      SHELBY     LETHA     
ALEX       : DEANDRE    SCOTT      JUAN      
JULIANA    : LAWANDA    JEROLD    
EDWARD     : AUGUST     VITO      
WILEY      : BARBRA     SOPHIA     WILBUR     RONNIE     DEVIN      ANTOINETTE ENRIQUE   
ANTOINETTE : SCOT       YONG       INGRID     GAY        WILEY     
DOMINICK   : BRET       GUY        PRESTON    STACY      PEARLIE    ANIBAL    
MIRANDA    : LILLY     
LILLY      : ROXIE      WALTER     MIRANDA   
FANNIE     : EDGARDO    LINDSEY    DELBERT   
ERNA       : SHERMAN    KARINA    
WILLA      : DEON       RUSSELL    ROSENDO   
PENELOPE   : ROOSEVELT  VAN       
STACI      : NATHAN     RHODA      ROSS      
ROSS       : LAZARO     MAC        STACI     
FRED       : NATASHA    MARGRET    AMELIA    
CORNELIUS  : RACHAEL    FREDDY     DESIREE    NICOLAS    DUDLEY    
SANTOS     : BENJAMIN   BLAINE    
BLAINE     : JAKE       ELISEO     HUGO       SANTOS    
MATILDA    : STANLEY    DARWIN     ROSEMARIE  WILLIE     SHERRIE   
ANNMARIE   : LENARD    
ELIAS      : ALEXANDRA  SUZETTE    ARLINE    
DUDLEY     : FRANCESCA  LORA       CORNELIUS 
CHI        : RUPERT    
LLOYD      : LUCY       JOSIE      FANNY      ALLAN      MARISSA   
MYRNA      : SERGIO     ELINOR     FRANKIE    RIGOBERTO 
ROBERTO    : OFELIA     MASON     
SHARRON    : ESMERALDA  DARIUS     MARTY     
TRENTON    : MARLIN     WINNIE     NORBERT    QUINCY     RORY      
BRIGITTE   : EDGARDO    LILA      
RON        : DEREK      JOHN       DODO      
ROCCO      : JIM        GERALDINE 
JAN        : KIM        CAROL      ABIGAIL    KARINA    
MARQUITA   : LEA        ROBT       GLORIA     ALISHA    
ALFONZO    : ABRAHAM    SALVATORE 
SALVATORE  : CLEO       RICO       LAURIE     ALFONZO   
ROGELIO    : JANETTE    SUE        ROBBY     
ROBBY      : DEWAYNE    ART        CLARK      JUANA      ROGELIO   
LOUELLA    : CHANDRA    MARION     ROSARIO    ERIKA     
LYDIA      : GERARDO    THERESE    ORVAL     
MARCEL     : MARGARITO  BRYON      JOAQUIN    JAMIE      MICHELE   
BECKY      : KELLI      DORA       KATE      
JANNA      : GENEVA    
JAYNE      : SHERYL     GALEN      LUELLA     GERALD    
CHERI      : LIZA       MARION     LEONOR     KAREEM    
MELBA      : SAL        MARYLOU   
SAL        : SONDRA     MELBA     
MILLICENT  : CHRISTIAN  BRICE      HUNG       GLADYS    
VONDA      : ALEXIS     RENE       RAE        AURORA     ALLAN     
IVANA      : JANICE     HARRY      ROD       
ADOLFO     : BRIDGET    ALBERT     ALEXANDER 
SAMMY      : PAMELA     SONIA      QUEEN     
LUCILLE    : IRENE     
BRUNO      : ROBBIE     RILEY     
MANUEL     : LOTTIE     JANELL     DEIRDRE   
JAVIER     : MARGARITA  JULIA      PASQUALE   CARLO     
OLIVE      : JANELLE   
AVERY      : MAY        SONYA      DEANN      ROSE       MAUDE     
ESTER      : SOPHIE     MERLE     
REX        : BRANDIE    JANINE     CHARLOTTE  MARCO      MATHEW    
LYNNE      : JOYCE      FREIDA     TERRA      RAYMUNDO  
LANDON     : ORA        LORRIE     LILIAN     ALAN      
JOEL       : POLLY      DONALD     KAYE       ORLANDO    BRANT     
JOSEFA     : VERNA      ALYSON     ADOLPH     SIDNEY    
LATOYA     : KRISTY     ROSETTA    FRANKIE   
PEDRO      : GUILLERMO  DREW       JERRY     
DARRELL    : LETICIA    CAMILLE   
ELLIOTT    : FRANCES    FRANKLIN   MARC      
MARC       : SHIRLEY    STERLING   ELLIOTT   
CECIL      : FLOYD      WANDA      JULIE      DARIO     
ABE        : GILDA      LATISHA    DENNY      ALEC      
THANH      : GLENNA     ELVIS      CHRISTIAN  SHARON     JENNA     
JOHNATHAN  : TRISHA     REGGIE     LAMONT     LIZ        KRISTOPHER
CHERYL     : ESTELLE    CHESTER   
LON        : HELGA      NICOLAS   
LORIE      : REGINA     MOHAMMED  
DEWEY      : JONAS      NAPOLEON   NORMAN    
SHERI      : KRIS       BERNADINE  SALLIE     ED        
GUS        : SANFORD    NATALIA    SEAN      
DOUG       : LAVERN     LUCIANO   
GROVER     : ALDEN      LANE       LOYD      
ERICH      : MOISES     SARAH      IRENE     
LOLA       : FEDERICO   MARTA      ALAN       MARCELO   
LORRAINE   : YOUNG      DARLENE    JACKSON    ISAIAH    
MAURO      : PAMELA    
ANNABELLE  : KELSEY     JAYSON    
RAYMOND    : ELIZABETH  LAUREN     EMILIA     GINA       EILEEN    
AVA        : LAMONT     DIANNE     LORAINE   
ALAN       : GENA       AGUSTIN    ROB        TISHA      LANDON     LOLA      
YESENIA    : RICH       MARIAN    
GLADYS     : MARY       KRISTOPHER MILLICENT  DONNY     
LAURA      : STELLA     PETER      ELTON      AHMED     
RODNEY     : HENRIETTA 
PHYLLIS    : BLAKE      REFUGIO    LESSIE     RODRICK   
DYLAN      : CAMILLE    EVE        GUY        TERRENCE   ISAAC     
DOYLE      : DARLENE    CORINE    
LOUIS      : IRVING     STEVIE     MABLE      WILLIAMS   ANTOINE   
TONI       : BRITTNEY   MAURICIO   BEN       
BEN        : REYES      CHARLOTTE  LYNNETTE   TONI      
ROLANDO    : BILLY      WINSTON    JASMINE    LAKEISHA   JESUS      BERTIE    
HORACE     : CANDICE    MARK      
LUCAS      : JEWEL      MELISSA   
CONNIE     : ISRAEL     ROBBIE     TROY       BENJAMIN   DILLON     BRADFORD   LELA      
AVIS       : LELAND     STUART     REGINALD   CALLIE    
JOSHUA     : BONNIE     BRYCE     
FAUSTINO   : LEAH      
JERROD     : ANGELO     KIM        SUSANNE    NATHANIEL 
ASHLEE     : ANTWAN     WALKER    
AISHA      : LENORA    
ELVIN      : MAGDALENA  ADDIE      EVERETTE  
ADDIE      : JOSEFINA   GLENNA     SOLOMON    CURT       ELVIN     
AHMED      : GLENN      LAURA     
ANTONY     : CLEO       ELBA       MARQUIS    ERNEST     PENNY      WALTER     RUSS      
LYNDA      : OFELIA     MARTIN     LUELLA    
DOMINGO    : DION       LOWELL     BEVERLEY   ERNESTINE  BARBARA   
CATALINA   : ARTURO     NIGEL      DEWAYNE    OLIN       RONNIE     KELLIE     JENNA     
MAJOR      : BILL       GARLAND    TONY      
HERSHEL    : HELEN      FABIAN    
KARINA     : EMMA       ERNA       JAN       
RICARDO    : SHANA      LES        HARRIET   
REYNALDO   : GAVIN      BRIDGETT   AUDREY     TRAVIS     MAGDALENA 
ERWIN      : REBEKAH    DAVID      KAY        BRITTANY  
CATHRYN    : NADIA      ALI        DELMAR    
JEFFREY    : CARMEN     CARLY      SONNY      KAREN     
DEXTER     : CHASITY    MARCELINO 
ABBY       : LINDSEY    BROOKE     BART       FRANK     
LUIS       : IMELDA     THERON    
CHASE      : JACLYN     AURELIA    ROSARIO   
JUDSON     : KIRK      
FELIX      : BROCK      JESSIE     TAMRA     
BRENT      : ROGER      HUGH       RICK      
JARVIS     : JOAN      
MEAGAN     : ROSIE      LENORA     IDA       
MAYNARD    : GALE       KURTIS    
INES       : LELIA      ELLEN      LAVERNE    KATE      
MACK       : RUBIN      HALEY      CASSIE    
DOROTHEA   : PAMELA     CORINNE    DOLLIE    
BEVERLY    : RUBIN      MATTIE    
CARMINE    : EDWIN      INGRID    
KERI       : ALPHONSO   XAVIER    
RODOLFO    : LATASHA    OTTO      
ROSALYN    : KENDALL    DOMINIC    ROSENDO    ELIZA      GERRY     
EVANGELINA : TOBY       ELTON     
HARLAN     : MAXWELL    QUINN      GUY       
ALYSSA     : ADRIAN     JARED      FANNY      GERALD    
PABLO      : BRITTNEY   ANTONE     SHELBY     CHRISTA   
CLAYTON    : STELLA     ADELINE    BARBRA     FREDA     
IDA        : ANTWAN     GAY        NORMA      MEAGAN    
MARISA     : LAUREL     MATTHEW    LUCILE    
VANCE      : BRYON      CHANDRA    FIDEL      DIANN     
ANDREW     : KEITH      FLOSSIE   
KEITH      : BRADLEY    ANDREW    
MINDY      : TRAVIS     AMOS       DONNY      JERI      
AMOS       : SUZETTE    MINDY     
DOLLY      : KATY       LAUREL     STEVEN    
MARISSA    : GRAHAM     HOWARD     LLOYD     
FLOSSIE    : POLLY      JAIME      ANDREW    
CRYSTAL    : HOUSTON    GAIL       ROLLAND   
BRITNEY    : GRACE      IRMA       AGUSTIN    ELISABETH 
DICK       : MOHAMMAD  
LETHA      : FRANCIS    LETICIA    LINDSEY    JASPER     LOIS       OPAL       DARREN    
DARREN     : NATASHA    LANA       PAULA      LETHA     
DANNY      : MICHAEL    CHRISTY    PAUL       ALICE     
DERICK     : TIM        KATHLEEN   ROSEMARIE  DODO      
MARGERY    : JEANIE     CLAUDIO   
SHERRIE    : JULIANNE   ARMAND     MARLON     MATILDA   
ERIKA      : LEO        LOUELLA    GERRY     
RENEE      : JEAN       RILEY      RAY       
MADELYN    : ERVIN      ELEANOR    LULA       IVORY     
MARYANN    : RONALD     SHANNON   
CELINA     : RICO       FRANCIS    KARYN     
JOSE       : KIRBY      BERNADINE  ANGELA     GOLDIE    
MARTINA    : HILARIO    FRITZ      FANNY     
EFREN      : ALLYSON    STERLING   GARY       CYNTHIA   
ALTHEA     : AUDREY     CLAUDIO    HELENE    
BRANT      : SANDY      LEANN      JEANNIE    JOEL      
JEFFEREY   : LEONARD    JED        JEANNETTE 
RIGOBERTO  : JOHN       RONALD     MYRNA     
JEANNE     : LIZA       CLINTON    DREW       DONNIE    
GRETA      : DEMETRIUS  BERNARDO  
ANTOINE    : AIMEE      LOUIS     
MAUDE      : SETH       KERRY      DREW       ELISE      AVERY     
TYREE      : TESSA      IVA       
VERA       : HOLLIS     GWEN       SEYMOUR    ALLAN     
BARBARA    : CLEO       COLLEEN    DOMINGO   
ENRIQUE    : TRISHA     CARLY      YOLANDA    BOBBY      WILEY      ED         DEENA     
ED         : HERIBERTO  GUADALUPE  SHERI      ENRIQUE   
GERRY      : MICHEAL    RAQUEL     ROSALYN    ERIKA     
HARLEY     : BARRY      JAMES      LEE       
KATE       : LILIA      BECKY      INES      
VAN        : YVONNE     PENELOPE  
BEULAH     : KIMBERLY   HEATHER   
KELVIN     : BRANDEN    LIDIA      CASSIE    
DONNY      : GLADYS     MINDY     
BRIAN      : GREGORIO   KIRBY     
DAN        : CHRISTOPER
BURTON     : WILL      
MARIANO    : AUBREY     DEANNA     SON       
LINDSAY    : ALEXANDRIA SUE        ROXANNE   
ELSA       : GRACIELA   LILLIE     BETH      
JEANNINE   : ERMA       CHRISTY    LIZ        BENNY      LENNY     
DANIELLE   : LEONARDO   RAY       
EVERETT    : HENRY      LINDA      EVAN      
ROYCE      : SANTIAGO   WADE       BRICE     
LAURI      : MASON     
BRADLY     : MONTY      TABITHA   
STAN       : SANFORD    CHERRY     DEENA      LILLIAN   
ARON       : SCOT       PHILLIP    LEWIS     
MAXINE     : DANIAL    
REID       : PAT        DEBBIE    
JOESPH     : HATTIE     TRENT     
MARVIN     : KATHERINE  JANICE    
KENYA      : CELESTE   
EVELYN     : SILVIA    
ETHEL      : DIRK       CAROLE    
PATRICK    : WILSON     COLLIN     EARLINE    DELMAR    
DELMAR     : PRESTON    CATHRYN    PATRICK   
WILFREDO   : ANGIE     
MARYANNE   : TREVOR    
AMELIA     : FRANCESCA  TAD        TAMMI      FRED       QUEEN     
PAULETTE   : MARLENE    BENITA    
ANGELITA   : BRANDON    FREDRIC   
BRADFORD   : KEN        GEOFFREY   LORENA     INGRID     CONNIE    
CARTER     : ERIN       PRISCILLA  JANA       TAMIKA    
ARNOLD     : MARTA      AL         LENORA    
LORETTA    : KERRY      JARROD    
WILBURN    : MARA       SHARLENE   RAYMUNDO  
WILTON     : LEANN      EVANGELINE
CHUCK      : JOSEPH     SHAWN      FRANCIS    CLAIRE     MARCIE    
BENNETT    : LOREN      ARRON     
EVA        : ANTONE     KIETH     
ALEXANDER  : FRANCES    ADOLFO    
RAYMUNDO   : APRIL      TRACY      LYNNE      WILBURN   
MARCIA     : TRISHA     DONNELL   
MATHEW     : MERVIN     KENNY      LEANNA     REX        ROBERTA   
ANIBAL     : OTTO       DOMINICK  
CHRISTINA  : JESSIE     ALISON    
VAUGHN     : NICOLAS    BRANDY    
BRAIN      : STANLEY    DIANNA     RACHEL    
KARYN      : PRINCE     CELINA    
SADIE      : MOHAMMED   KATHARINE  DEBBIE    
JODIE      : BERT       LAMONT    
CARSON     : MELISA     JOHNATHON  BUDDY      CARLENE   
DAMIAN     : AURELIO    JOSIE     
DONNIE     : ROMEO      LEIGH      JEANNE    
SCOTTIE    : SHANNON    KATHERYN  
KATHERYN   : DUNCAN     SCOTTIE   
HARRISON   : NOE        WARREN    
LADONNA    : WILLIE    
MARTY      : KENDRICK   SHARRON   
KIMBERLEY  : ERMA       CLYDE      WINIFRED   CEDRIC    
QUEEN      : MARLIN     SAMMY      AMELIA    
RANDAL     : AMALIA     DORA       GRETCHEN  
EDWARDO    : BERNARD    PETRA     
PETRA      : EVAN       EDWARDO   
FRANK      : ILENE      RYAN       LUCIA      ABBY      
JOANNA     : RANDALL   
RANDALL    : COCO       JOANNA    
MARYLOU    : CARLENE    MELBA     
JESS       : LYNN       DOROTHY   
SHERRI     : NANETTE    LULA      
NORMAN     : DEWAYNE    ANNE       DEWEY     
JERI       : RODRIGO    HARRIET    MINDY     
EVERETTE   : MAY        MADELINE   FORREST    ELVIN     
KIRSTEN    : SHAWN      GIOVANNI   JACOB     
OMAR       : VELMA      JEANETTE   GRETCHEN  
RORY       : LAWANDA    TAMARA     SHEENA     TRENTON   
MARIAN     : NANNIE     TRACI      YESENIA   
ARNULFO    : KRIS      
LEROY      : BOB       
CINDY      : JULIO      POLLY     
KITTY      : ALEXIS     ANDY       DWIGHT    
MARCELO    : SONNY      SIMONE     LOLA      
DEENA      : IMELDA     DORA       ENRIQUE    STAN      
ROSALINDA  : EARLE      JEAN      
DOLLIE     : DEWITT     SHELLY     DOROTHEA  
MILAGROS   : THERESE    DOMINIC    DODO      
REBA       : PRISCILLA  NORMA     
CODY       : AMY        CLARE     
BETH       : ELLIS      ELSA      
BERNIE     : CHASITY    ROBBIE     BRYCE      SHANE     
RENA       : WELDON     ADELA     
LILLIAN    : CLEO       LULU       STAN      
LACY       : MINNIE     MISTY     
CARRIE     : LEMUEL     BENITA    
CLAUDETTE  : ALICE     
ELWOOD     : NOREEN     SUSAN      ORVILLE    BRETT     
SYLVIA     : JONAS      ANGELIQUE  DORIAN    
CARMELO    : ROSETTA    MAX       
KAY        : CORA       ERWIN     
DENVER     : JANICE    
LELA       : SELENA     SCOTT      PAULA      CONNIE    
ARIEL      : GAYLE      RAMONA    
EMORY      : FRANKIE   
SCOTTY     : TAD        CRISTINA   MELODY     FELECIA   
NICHOLE    : MINNIE    
HAZEL      : DIEGO      NELL      
MAGGIE     : KATHLEEN  
GINGER     : LOU       
ZACHARY    : MILES      TAMARA    
ALISHA     : MARYELLEN  NELDA      MARQUITA  
HILLARY    : MARIANA    EARNEST    NATALIA   
LILY       : LEMUEL     DAVID     
MARCIE     : LENORA     CHUCK     
WINIFRED   : KIMBERLEY 
INEZ       : YOUNG      GUADALUPE 
ELOISE     : ALDO       IRMA      
ROBERTA    : CARROLL    MATHEW    
HERBERT    : ZANE       SIMONE    
HARRIS     : JANNIE    
SON        : REINALDO   MARIANO   
SONJA      : JAMAL     
BRETT      : ALFREDO    ELWOOD    
LEONEL     : MITZI     
IVORY      : CHESTER    MADELYN    NINA      
NINA       : GEORGINA   IVORY     
ODELL      : ASHLEY     DEWAYNE    TABITHA   
EMILIO     : ESTELLE    BRANDEN   
CONCEPCION : JASMINE    IAN       
TONYA      : ANTONIA   
MANUELA    : ZELMA     
VICTORIA   : KATHARINE 
BRITTANY   : ERWIN     
MARK       : HORACE    
CEDRIC     : KIMBERLEY 
JAYSON     : ANNABELLE 
CECELIA    : KRIS      
DENIS      : LUTHER    
